Name	ReportingUnitType
VA House District 1	state-house
VA House District 2	state-house
VA House District 3	state-house
VA House District 4	state-house
VA House District 5	state-house
VA House District 6	state-house
VA House District 7	state-house
VA House District 8	state-house
VA House District 9	state-house
VA House District 10	state-house
VA House District 11	state-house
VA House District 12	state-house
VA House District 13	state-house
VA House District 14	state-house
VA House District 15	state-house
VA House District 16	state-house
VA House District 17	state-house
VA House District 18	state-house
VA House District 19	state-house
VA House District 20	state-house
VA House District 21	state-house
VA House District 22	state-house
VA House District 23	state-house
VA House District 24	state-house
VA House District 25	state-house
VA House District 26	state-house
VA House District 27	state-house
VA House District 28	state-house
VA House District 29	state-house
VA House District 30	state-house
VA House District 31	state-house
VA House District 32	state-house
VA House District 33	state-house
VA House District 34	state-house
VA House District 35	state-house
VA House District 36	state-house
VA House District 37	state-house
VA House District 38	state-house
VA House District 39	state-house
VA House District 40	state-house
VA House District 41	state-house
VA House District 42	state-house
VA House District 43	state-house
VA House District 44	state-house
VA House District 45	state-house
VA House District 46	state-house
VA House District 47	state-house
VA House District 48	state-house
VA House District 49	state-house
VA House District 50	state-house
VA House District 51	state-house
VA House District 52	state-house
VA House District 53	state-house
VA House District 54	state-house
VA House District 55	state-house
VA House District 56	state-house
VA House District 57	state-house
VA House District 58	state-house
VA House District 59	state-house
VA House District 60	state-house
VA House District 61	state-house
VA House District 62	state-house
VA House District 63	state-house
VA House District 64	state-house
VA House District 65	state-house
VA House District 66	state-house
VA House District 67	state-house
VA House District 68	state-house
VA House District 69	state-house
VA House District 70	state-house
VA House District 71	state-house
VA House District 72	state-house
VA House District 73	state-house
VA House District 74	state-house
VA House District 75	state-house
VA House District 76	state-house
VA House District 77	state-house
VA House District 78	state-house
VA House District 79	state-house
VA House District 80	state-house
VA House District 81	state-house
VA House District 82	state-house
VA House District 83	state-house
VA House District 84	state-house
VA House District 85	state-house
VA House District 86	state-house
VA House District 87	state-house
VA House District 88	state-house
VA House District 89	state-house
VA House District 90	state-house
VA House District 91	state-house
VA House District 92	state-house
VA House District 93	state-house
VA House District 94	state-house
VA House District 95	state-house
VA House District 96	state-house
VA House District 97	state-house
VA House District 98	state-house
VA House District 99	state-house
VA House District 100	state-house
VA Senate District 1	state-senate
VA Senate District 2	state-senate
VA Senate District 3	state-senate
VA Senate District 4	state-senate
VA Senate District 5	state-senate
VA Senate District 6	state-senate
VA Senate District 7	state-senate
VA Senate District 8	state-senate
VA Senate District 9	state-senate
VA Senate District 10	state-senate
VA Senate District 11	state-senate
VA Senate District 12	state-senate
VA Senate District 13	state-senate
VA Senate District 14	state-senate
VA Senate District 15	state-senate
VA Senate District 16	state-senate
VA Senate District 17	state-senate
VA Senate District 18	state-senate
VA Senate District 19	state-senate
VA Senate District 20	state-senate
VA Senate District 21	state-senate
VA Senate District 22	state-senate
VA Senate District 23	state-senate
VA Senate District 24	state-senate
VA Senate District 25	state-senate
VA Senate District 26	state-senate
VA Senate District 27	state-senate
VA Senate District 28	state-senate
VA Senate District 29	state-senate
VA Senate District 30	state-senate
VA Senate District 31	state-senate
VA Senate District 32	state-senate
VA Senate District 33	state-senate
VA Senate District 34	state-senate
VA Senate District 35	state-senate
VA Senate District 36	state-senate
VA Senate District 37	state-senate
VA Senate District 38	state-senate
VA Senate District 39	state-senate
VA Senate District 40	state-senate
US House VA District 1	congressional
US House VA District 2	congressional
US House VA District 3	congressional
US House VA District 4	congressional
US House VA District 5	congressional
US House VA District 6	congressional
US House VA District 7	congressional
US House VA District 8	congressional
US House VA District 9	congressional
US House VA District 10	congressional
US House VA District 11	congressional
Virginia	state
Virginia;Falls Church City	city
Virginia;Alexandria City	city
Virginia;Bristol City	city
Virginia;Buena Vista City	city
Virginia;Charlottesville City	city
Virginia;Chesapeake City	city
Virginia;Colonial Heights City	city
Virginia;Covington City	city
Virginia;Danville City	city
Virginia;Emporia City	city
Virginia;Fairfax City	city
Virginia;Franklin City	city
Virginia;Fredericksburg City	city
Virginia;Galax City	city
Virginia;Hampton City	city
Virginia;Harrisonburg City	city
Virginia;Hopewell City	city
Virginia;Lexington City	city
Virginia;Lynchburg City	city
Virginia;Manassas City	city
Virginia;Manassas Park City	city
Virginia;Martinsville City	city
Virginia;Newport News City	city
Virginia;Norfolk City	city
Virginia;Norton City	city
Virginia;Petersburg City	city
Virginia;Poquoson City	city
Virginia;Portsmouth City	city
Virginia;Radford City	city
Virginia;Richmond City	city
Virginia;Roanoke City	city
Virginia;Salem City	city
Virginia;Staunton City	city
Virginia;Suffolk City	city
Virginia;Virginia Beach City	city
Virginia;Waynesboro City	city
Virginia;Williamsburg City	city
Virginia;Winchester City	city
Virginia;Charles City County	county
Virginia;James City County	county
Virginia;Accomack County	county
Virginia;Albemarle County	county
Virginia;Alleghany County	county
Virginia;Amelia County	county
Virginia;Amherst County	county
Virginia;Appomattox County	county
Virginia;Arlington County	county
Virginia;Augusta County	county
Virginia;Bath County	county
Virginia;Bedford County	county
Virginia;Bland County	county
Virginia;Botetourt County	county
Virginia;Brunswick County	county
Virginia;Buchanan County	county
Virginia;Buckingham County	county
Virginia;Campbell County	county
Virginia;Caroline County	county
Virginia;Carroll County	county
Virginia;Charlotte County	county
Virginia;Chesterfield County	county
Virginia;Clarke County	county
Virginia;Craig County	county
Virginia;Culpeper County	county
Virginia;Cumberland County	county
Virginia;Dickenson County	county
Virginia;Dinwiddie County	county
Virginia;Essex County	county
Virginia;Fairfax County	county
Virginia;Fauquier County	county
Virginia;Floyd County	county
Virginia;Fluvanna County	county
Virginia;Franklin County	county
Virginia;Frederick County	county
Virginia;Giles County	county
Virginia;Gloucester County	county
Virginia;Goochland County	county
Virginia;Grayson County	county
Virginia;Greene County	county
Virginia;Greensville County	county
Virginia;Halifax County	county
Virginia;Hanover County	county
Virginia;Henrico County	county
Virginia;Henry County	county
Virginia;Highland County	county
Virginia;Isle Of Wight County	county
Virginia;King & Queen County	county
Virginia;King George County	county
Virginia;King William County	county
Virginia;Lancaster County	county
Virginia;Lee County	county
Virginia;Loudoun County	county
Virginia;Louisa County	county
Virginia;Lunenburg County	county
Virginia;Madison County	county
Virginia;Mathews County	county
Virginia;Mecklenburg County	county
Virginia;Middlesex County	county
Virginia;Montgomery County	county
Virginia;Nelson County	county
Virginia;New Kent County	county
Virginia;Northampton County	county
Virginia;Northumberland County	county
Virginia;Nottoway County	county
Virginia;Orange County	county
Virginia;Page County	county
Virginia;Patrick County	county
Virginia;Pittsylvania County	county
Virginia;Powhatan County	county
Virginia;Prince Edward County	county
Virginia;Prince George County	county
Virginia;Prince William County	county
Virginia;Pulaski County	county
Virginia;Rappahannock County	county
Virginia;Richmond County	county
Virginia;Roanoke County	county
Virginia;Rockbridge County	county
Virginia;Rockingham County	county
Virginia;Russell County	county
Virginia;Scott County	county
Virginia;Shenandoah County	county
Virginia;Smyth County	county
Virginia;Southampton County	county
Virginia;Spotsylvania County	county
Virginia;Stafford County	county
Virginia;Surry County	county
Virginia;Sussex County	county
Virginia;Tazewell County	county
Virginia;Warren County	county
Virginia;Washington County	county
Virginia;Westmoreland County	county
Virginia;Wise County	county
Virginia;Wythe County	county
Virginia;York County	county
