Name	ReportingUnitType
Massachusetts;MA House District 1	state-house
Massachusetts;MA House District 2	state-house
Massachusetts;MA House District 3	state-house
Massachusetts;MA House District 4	state-house
Massachusetts;MA House District 5	state-house
Massachusetts;MA House District 6	state-house
Massachusetts;MA House District 7	state-house
Massachusetts;MA House District 8	state-house
Massachusetts;MA House District 9	state-house
Massachusetts;MA House District 10	state-house
Massachusetts;MA House District 11	state-house
Massachusetts;MA House District 12	state-house
Massachusetts;MA House District 13	state-house
Massachusetts;MA House District 14	state-house
Massachusetts;MA House District 15	state-house
Massachusetts;MA House District 16	state-house
Massachusetts;MA House District 17	state-house
Massachusetts;MA House District 18	state-house
Massachusetts;MA House District 19	state-house
Massachusetts;MA House District 20	state-house
Massachusetts;MA House District 21	state-house
Massachusetts;MA House District 22	state-house
Massachusetts;MA House District 23	state-house
Massachusetts;MA House District 24	state-house
Massachusetts;MA House District 25	state-house
Massachusetts;MA House District 26	state-house
Massachusetts;MA House District 27	state-house
Massachusetts;MA House District 28	state-house
Massachusetts;MA House District 29	state-house
Massachusetts;MA House District 30	state-house
Massachusetts;MA House District 31	state-house
Massachusetts;MA House District 32	state-house
Massachusetts;MA House District 33	state-house
Massachusetts;MA House District 34	state-house
Massachusetts;MA House District 35	state-house
Massachusetts;MA House District 36	state-house
Massachusetts;MA House District 37	state-house
Massachusetts;MA House District 38	state-house
Massachusetts;MA House District 39	state-house
Massachusetts;MA House District 40	state-house
Massachusetts;MA House District 41	state-house
Massachusetts;MA House District 42	state-house
Massachusetts;MA House District 43	state-house
Massachusetts;MA House District 44	state-house
Massachusetts;MA House District 45	state-house
Massachusetts;MA House District 46	state-house
Massachusetts;MA House District 47	state-house
Massachusetts;MA House District 48	state-house
Massachusetts;MA House District 49	state-house
Massachusetts;MA House District 50	state-house
Massachusetts;MA House District 51	state-house
Massachusetts;MA House District 52	state-house
Massachusetts;MA House District 53	state-house
Massachusetts;MA House District 54	state-house
Massachusetts;MA House District 55	state-house
Massachusetts;MA House District 56	state-house
Massachusetts;MA House District 57	state-house
Massachusetts;MA House District 58	state-house
Massachusetts;MA House District 59	state-house
Massachusetts;MA House District 60	state-house
Massachusetts;MA House District 61	state-house
Massachusetts;MA House District 62	state-house
Massachusetts;MA House District 63	state-house
Massachusetts;MA House District 64	state-house
Massachusetts;MA House District 65	state-house
Massachusetts;MA House District 66	state-house
Massachusetts;MA House District 67	state-house
Massachusetts;MA House District 68	state-house
Massachusetts;MA House District 69	state-house
Massachusetts;MA House District 70	state-house
Massachusetts;MA House District 71	state-house
Massachusetts;MA House District 72	state-house
Massachusetts;MA House District 73	state-house
Massachusetts;MA House District 74	state-house
Massachusetts;MA House District 75	state-house
Massachusetts;MA House District 76	state-house
Massachusetts;MA House District 77	state-house
Massachusetts;MA House District 78	state-house
Massachusetts;MA House District 79	state-house
Massachusetts;MA House District 80	state-house
Massachusetts;MA House District 81	state-house
Massachusetts;MA House District 82	state-house
Massachusetts;MA House District 83	state-house
Massachusetts;MA House District 84	state-house
Massachusetts;MA House District 85	state-house
Massachusetts;MA House District 86	state-house
Massachusetts;MA House District 87	state-house
Massachusetts;MA House District 88	state-house
Massachusetts;MA House District 89	state-house
Massachusetts;MA House District 90	state-house
Massachusetts;MA House District 91	state-house
Massachusetts;MA House District 92	state-house
Massachusetts;MA House District 93	state-house
Massachusetts;MA House District 94	state-house
Massachusetts;MA House District 95	state-house
Massachusetts;MA House District 96	state-house
Massachusetts;MA House District 97	state-house
Massachusetts;MA House District 98	state-house
Massachusetts;MA House District 99	state-house
Massachusetts;MA House District 100	state-house
Massachusetts;MA House District 101	state-house
Massachusetts;MA House District 102	state-house
Massachusetts;MA House District 103	state-house
Massachusetts;MA House District 104	state-house
Massachusetts;MA House District 105	state-house
Massachusetts;MA House District 106	state-house
Massachusetts;MA House District 107	state-house
Massachusetts;MA House District 108	state-house
Massachusetts;MA House District 109	state-house
Massachusetts;MA House District 110	state-house
Massachusetts;MA House District 111	state-house
Massachusetts;MA House District 112	state-house
Massachusetts;MA House District 113	state-house
Massachusetts;MA House District 114	state-house
Massachusetts;MA House District 115	state-house
Massachusetts;MA House District 116	state-house
Massachusetts;MA House District 117	state-house
Massachusetts;MA House District 118	state-house
Massachusetts;MA House District 119	state-house
Massachusetts;MA House District 120	state-house
Massachusetts;MA House District 121	state-house
Massachusetts;MA House District 122	state-house
Massachusetts;MA House District 123	state-house
Massachusetts;MA House District 124	state-house
Massachusetts;MA House District 125	state-house
Massachusetts;MA House District 126	state-house
Massachusetts;MA House District 127	state-house
Massachusetts;MA House District 128	state-house
Massachusetts;MA House District 129	state-house
Massachusetts;MA House District 130	state-house
Massachusetts;MA House District 131	state-house
Massachusetts;MA House District 132	state-house
Massachusetts;MA House District 133	state-house
Massachusetts;MA House District 134	state-house
Massachusetts;MA House District 135	state-house
Massachusetts;MA House District 136	state-house
Massachusetts;MA House District 137	state-house
Massachusetts;MA House District 138	state-house
Massachusetts;MA House District 139	state-house
Massachusetts;MA House District 140	state-house
Massachusetts;MA House District 141	state-house
Massachusetts;MA House District 142	state-house
Massachusetts;MA House District 143	state-house
Massachusetts;MA House District 144	state-house
Massachusetts;MA House District 145	state-house
Massachusetts;MA House District 146	state-house
Massachusetts;MA House District 147	state-house
Massachusetts;MA House District 148	state-house
Massachusetts;MA House District 149	state-house
Massachusetts;MA House District 150	state-house
Massachusetts;MA House District 151	state-house
Massachusetts;MA House District 152	state-house
Massachusetts;MA House District 153	state-house
Massachusetts;MA House District 154	state-house
Massachusetts;MA House District 155	state-house
Massachusetts;MA House District 156	state-house
Massachusetts;MA House District 157	state-house
Massachusetts;MA House District 158	state-house
Massachusetts;MA House District 159	state-house
Massachusetts;MA House District 160	state-house
Massachusetts;MA Senate District 1	state-senate
Massachusetts;MA Senate District 2	state-senate
Massachusetts;MA Senate District 3	state-senate
Massachusetts;MA Senate District 4	state-senate
Massachusetts;MA Senate District 5	state-senate
Massachusetts;MA Senate District 6	state-senate
Massachusetts;MA Senate District 7	state-senate
Massachusetts;MA Senate District 8	state-senate
Massachusetts;MA Senate District 9	state-senate
Massachusetts;MA Senate District 10	state-senate
Massachusetts;MA Senate District 11	state-senate
Massachusetts;MA Senate District 12	state-senate
Massachusetts;MA Senate District 13	state-senate
Massachusetts;MA Senate District 14	state-senate
Massachusetts;MA Senate District 15	state-senate
Massachusetts;MA Senate District 16	state-senate
Massachusetts;MA Senate District 17	state-senate
Massachusetts;MA Senate District 18	state-senate
Massachusetts;MA Senate District 19	state-senate
Massachusetts;MA Senate District 20	state-senate
Massachusetts;MA Senate District 21	state-senate
Massachusetts;MA Senate District 22	state-senate
Massachusetts;MA Senate District 23	state-senate
Massachusetts;MA Senate District 24	state-senate
Massachusetts;MA Senate District 25	state-senate
Massachusetts;MA Senate District 26	state-senate
Massachusetts;MA Senate District 27	state-senate
Massachusetts;MA Senate District 28	state-senate
Massachusetts;MA Senate District 29	state-senate
Massachusetts;MA Senate District 30	state-senate
Massachusetts;MA Senate District 31	state-senate
Massachusetts;MA Senate District 32	state-senate
Massachusetts;MA Senate District 33	state-senate
Massachusetts;MA Senate District 34	state-senate
Massachusetts;MA Senate District 35	state-senate
Massachusetts;MA Senate District 36	state-senate
Massachusetts;MA Senate District 37	state-senate
Massachusetts;MA Senate District 38	state-senate
Massachusetts;MA Senate District 39	state-senate
Massachusetts;MA Senate District 40	state-senate
Massachusetts;US House MA District 1	congressional
Massachusetts;US House MA District 2	congressional
Massachusetts;US House MA District 3	congressional
Massachusetts;US House MA District 4	congressional
Massachusetts;US House MA District 5	congressional
Massachusetts;US House MA District 6	congressional
Massachusetts;US House MA District 7	congressional
Massachusetts;US House MA District 8	congressional
Massachusetts;US House MA District 9	congressional
Massachusetts	state
Massachusetts;Abington	city-or-town
Massachusetts;Acton	city-or-town
Massachusetts;Acushnet	city-or-town
Massachusetts;Adams	city-or-town
Massachusetts;Agawam	city-or-town
Massachusetts;Alford	city-or-town
Massachusetts;Amesbury	city-or-town
Massachusetts;Amherst	city-or-town
Massachusetts;Andover	city-or-town
Massachusetts;Aquinnah	city-or-town
Massachusetts;Arlington	city-or-town
Massachusetts;Ashburnham	city-or-town
Massachusetts;Ashby	city-or-town
Massachusetts;Ashfield	city-or-town
Massachusetts;Ashland	city-or-town
Massachusetts;Athol	city-or-town
Massachusetts;Attleboro	city-or-town
Massachusetts;Auburn	city-or-town
Massachusetts;Avon	city-or-town
Massachusetts;Ayer	city-or-town
Massachusetts;Barnstable	city-or-town
Massachusetts;Barre	city-or-town
Massachusetts;Becket	city-or-town
Massachusetts;Bedford	city-or-town
Massachusetts;Belchertown	city-or-town
Massachusetts;Bellingham	city-or-town
Massachusetts;Belmont	city-or-town
Massachusetts;Berkley	city-or-town
Massachusetts;Berlin	city-or-town
Massachusetts;Bernardston	city-or-town
Massachusetts;Beverly	city-or-town
Massachusetts;Billerica	city-or-town
Massachusetts;Blackstone	city-or-town
Massachusetts;Blandford	city-or-town
Massachusetts;Bolton	city-or-town
Massachusetts;Boston	city-or-town
Massachusetts;Bourne	city-or-town
Massachusetts;Boxborough	city-or-town
Massachusetts;Boxford	city-or-town
Massachusetts;Boylston	city-or-town
Massachusetts;Braintree	city-or-town
Massachusetts;Brewster	city-or-town
Massachusetts;Bridgewater	city-or-town
Massachusetts;Brimfield	city-or-town
Massachusetts;Brockton	city-or-town
Massachusetts;Brookfield	city-or-town
Massachusetts;Brookline	city-or-town
Massachusetts;Buckland	city-or-town
Massachusetts;Burlington	city-or-town
Massachusetts;Cambridge	city-or-town
Massachusetts;Canton	city-or-town
Massachusetts;Carlisle	city-or-town
Massachusetts;Carver	city-or-town
Massachusetts;Charlemont	city-or-town
Massachusetts;Charlton	city-or-town
Massachusetts;Chatham	city-or-town
Massachusetts;Chelmsford	city-or-town
Massachusetts;Chelsea	city-or-town
Massachusetts;Cheshire	city-or-town
Massachusetts;Chester	city-or-town
Massachusetts;Chesterfield	city-or-town
Massachusetts;Chicopee	city-or-town
Massachusetts;Chilmark	city-or-town
Massachusetts;Clarksburg	city-or-town
Massachusetts;Clinton	city-or-town
Massachusetts;Cohasset	city-or-town
Massachusetts;Colrain	city-or-town
Massachusetts;Concord	city-or-town
Massachusetts;Conway	city-or-town
Massachusetts;Cummington	city-or-town
Massachusetts;Dalton	city-or-town
Massachusetts;Danvers	city-or-town
Massachusetts;Dartmouth	city-or-town
Massachusetts;Dedham	city-or-town
Massachusetts;Deerfield	city-or-town
Massachusetts;Dennis	city-or-town
Massachusetts;Dighton	city-or-town
Massachusetts;Douglas	city-or-town
Massachusetts;Dover	city-or-town
Massachusetts;Dracut	city-or-town
Massachusetts;Dudley	city-or-town
Massachusetts;Dunstable	city-or-town
Massachusetts;Duxbury	city-or-town
Massachusetts;E. Bridgewater	city-or-town
Massachusetts;E. Brookfield	city-or-town
Massachusetts;E. Longmeadow	city-or-town
Massachusetts;Eastham	city-or-town
Massachusetts;Easthampton	city-or-town
Massachusetts;Easton	city-or-town
Massachusetts;Edgartown	city-or-town
Massachusetts;Egremont	city-or-town
Massachusetts;Erving	city-or-town
Massachusetts;Essex	city-or-town
Massachusetts;Everett	city-or-town
Massachusetts;Fairhaven	city-or-town
Massachusetts;Fall River	city-or-town
Massachusetts;Falmouth	city-or-town
Massachusetts;Fitchburg	city-or-town
Massachusetts;Florida	city-or-town
Massachusetts;Foxborough	city-or-town
Massachusetts;Framingham	city-or-town
Massachusetts;Franklin	city-or-town
Massachusetts;Freetown	city-or-town
Massachusetts;Gardner	city-or-town
Massachusetts;Georgetown	city-or-town
Massachusetts;Gill	city-or-town
Massachusetts;Gloucester	city-or-town
Massachusetts;Goshen	city-or-town
Massachusetts;Gosnold	city-or-town
Massachusetts;Grafton	city-or-town
Massachusetts;Granby	city-or-town
Massachusetts;Granville	city-or-town
Massachusetts;Great Barrington	city-or-town
Massachusetts;Greenfield	city-or-town
Massachusetts;Groton	city-or-town
Massachusetts;Groveland	city-or-town
Massachusetts;Hadley	city-or-town
Massachusetts;Halifax	city-or-town
Massachusetts;Hamilton	city-or-town
Massachusetts;Hampden	city-or-town
Massachusetts;Hancock	city-or-town
Massachusetts;Hanover	city-or-town
Massachusetts;Hanson	city-or-town
Massachusetts;Hardwick	city-or-town
Massachusetts;Harvard	city-or-town
Massachusetts;Harwich	city-or-town
Massachusetts;Hatfield	city-or-town
Massachusetts;Haverhill	city-or-town
Massachusetts;Hawley	city-or-town
Massachusetts;Heath	city-or-town
Massachusetts;Hingham	city-or-town
Massachusetts;Hinsdale	city-or-town
Massachusetts;Holbrook	city-or-town
Massachusetts;Holden	city-or-town
Massachusetts;Holland	city-or-town
Massachusetts;Holliston	city-or-town
Massachusetts;Holyoke	city-or-town
Massachusetts;Hopedale	city-or-town
Massachusetts;Hopkinton	city-or-town
Massachusetts;Hubbardston	city-or-town
Massachusetts;Hudson	city-or-town
Massachusetts;Hull	city-or-town
Massachusetts;Huntington	city-or-town
Massachusetts;Ipswich	city-or-town
Massachusetts;Kingston	city-or-town
Massachusetts;Lakeville	city-or-town
Massachusetts;Lancaster	city-or-town
Massachusetts;Lanesborough	city-or-town
Massachusetts;Lawrence	city-or-town
Massachusetts;Lee	city-or-town
Massachusetts;Leicester	city-or-town
Massachusetts;Lenox	city-or-town
Massachusetts;Leominster	city-or-town
Massachusetts;Leverett	city-or-town
Massachusetts;Lexington	city-or-town
Massachusetts;Leyden	city-or-town
Massachusetts;Lincoln	city-or-town
Massachusetts;Littleton	city-or-town
Massachusetts;Longmeadow	city-or-town
Massachusetts;Lowell	city-or-town
Massachusetts;Ludlow	city-or-town
Massachusetts;Lunenburg	city-or-town
Massachusetts;Lynn	city-or-town
Massachusetts;Lynnfield	city-or-town
Massachusetts;Malden	city-or-town
Massachusetts;Manchester-by-the-Sea	city-or-town
Massachusetts;Mansfield	city-or-town
Massachusetts;Marblehead	city-or-town
Massachusetts;Marion	city-or-town
Massachusetts;Marlborough	city-or-town
Massachusetts;Marshfield	city-or-town
Massachusetts;Mashpee	city-or-town
Massachusetts;Mattapoisett	city-or-town
Massachusetts;Maynard	city-or-town
Massachusetts;Medfield	city-or-town
Massachusetts;Medford	city-or-town
Massachusetts;Medway	city-or-town
Massachusetts;Melrose	city-or-town
Massachusetts;Mendon	city-or-town
Massachusetts;Merrimac	city-or-town
Massachusetts;Methuen	city-or-town
Massachusetts;Middleborough	city-or-town
Massachusetts;Middlefield	city-or-town
Massachusetts;Middleton	city-or-town
Massachusetts;Milford	city-or-town
Massachusetts;Millbury	city-or-town
Massachusetts;Millis	city-or-town
Massachusetts;Millville	city-or-town
Massachusetts;Milton	city-or-town
Massachusetts;Monroe	city-or-town
Massachusetts;Monson	city-or-town
Massachusetts;Montague	city-or-town
Massachusetts;Monterey	city-or-town
Massachusetts;Montgomery	city-or-town
Massachusetts;Mount Washington	city-or-town
Massachusetts;N. Adams	city-or-town
Massachusetts;N. Andover	city-or-town
Massachusetts;N. Attleborough	city-or-town
Massachusetts;N. Brookfield	city-or-town
Massachusetts;N. Reading	city-or-town
Massachusetts;Nahant	city-or-town
Massachusetts;Nantucket	city-or-town
Massachusetts;Natick	city-or-town
Massachusetts;Needham	city-or-town
Massachusetts;New Ashford	city-or-town
Massachusetts;New Bedford	city-or-town
Massachusetts;New Braintree	city-or-town
Massachusetts;New Marlborough	city-or-town
Massachusetts;New Salem	city-or-town
Massachusetts;Newbury	city-or-town
Massachusetts;Newburyport	city-or-town
Massachusetts;Newton	city-or-town
Massachusetts;Norfolk	city-or-town
Massachusetts;Northampton	city-or-town
Massachusetts;Northborough	city-or-town
Massachusetts;Northbridge	city-or-town
Massachusetts;Northfield	city-or-town
Massachusetts;Norton	city-or-town
Massachusetts;Norwell	city-or-town
Massachusetts;Norwood	city-or-town
Massachusetts;Oak Bluffs	city-or-town
Massachusetts;Oakham	city-or-town
Massachusetts;Orange	city-or-town
Massachusetts;Orleans	city-or-town
Massachusetts;Otis	city-or-town
Massachusetts;Oxford	city-or-town
Massachusetts;Palmer	city-or-town
Massachusetts;Paxton	city-or-town
Massachusetts;Peabody	city-or-town
Massachusetts;Pelham	city-or-town
Massachusetts;Pembroke	city-or-town
Massachusetts;Pepperell	city-or-town
Massachusetts;Peru	city-or-town
Massachusetts;Petersham	city-or-town
Massachusetts;Phillipston	city-or-town
Massachusetts;Pittsfield	city-or-town
Massachusetts;Plainfield	city-or-town
Massachusetts;Plainville	city-or-town
Massachusetts;Plymouth	city-or-town
Massachusetts;Plympton	city-or-town
Massachusetts;Princeton	city-or-town
Massachusetts;Provincetown	city-or-town
Massachusetts;Quincy	city-or-town
Massachusetts;Randolph	city-or-town
Massachusetts;Raynham	city-or-town
Massachusetts;Reading	city-or-town
Massachusetts;Rehoboth	city-or-town
Massachusetts;Revere	city-or-town
Massachusetts;Richmond	city-or-town
Massachusetts;Rochester	city-or-town
Massachusetts;Rockland	city-or-town
Massachusetts;Rockport	city-or-town
Massachusetts;Rowe	city-or-town
Massachusetts;Rowley	city-or-town
Massachusetts;Royalston	city-or-town
Massachusetts;Russell	city-or-town
Massachusetts;Rutland	city-or-town
Massachusetts;S. Hadley	city-or-town
Massachusetts;Salem	city-or-town
Massachusetts;Salisbury	city-or-town
Massachusetts;Sandisfield	city-or-town
Massachusetts;Sandwich	city-or-town
Massachusetts;Saugus	city-or-town
Massachusetts;Savoy	city-or-town
Massachusetts;Scituate	city-or-town
Massachusetts;Seekonk	city-or-town
Massachusetts;Sharon	city-or-town
Massachusetts;Sheffield	city-or-town
Massachusetts;Shelburne	city-or-town
Massachusetts;Sherborn	city-or-town
Massachusetts;Shirley	city-or-town
Massachusetts;Shrewsbury	city-or-town
Massachusetts;Shutesbury	city-or-town
Massachusetts;Somerset	city-or-town
Massachusetts;Somerville	city-or-town
Massachusetts;Southampton	city-or-town
Massachusetts;Southborough	city-or-town
Massachusetts;Southbridge	city-or-town
Massachusetts;Southwick	city-or-town
Massachusetts;Spencer	city-or-town
Massachusetts;Springfield	city-or-town
Massachusetts;Sterling	city-or-town
Massachusetts;Stockbridge	city-or-town
Massachusetts;Stoneham	city-or-town
Massachusetts;Stoughton	city-or-town
Massachusetts;Stow	city-or-town
Massachusetts;Sturbridge	city-or-town
Massachusetts;Sudbury	city-or-town
Massachusetts;Sunderland	city-or-town
Massachusetts;Sutton	city-or-town
Massachusetts;Swampscott	city-or-town
Massachusetts;Swansea	city-or-town
Massachusetts;Taunton	city-or-town
Massachusetts;Templeton	city-or-town
Massachusetts;Tewksbury	city-or-town
Massachusetts;Tisbury	city-or-town
Massachusetts;Tolland	city-or-town
Massachusetts;Topsfield	city-or-town
Massachusetts;TOTALS	city-or-town
Massachusetts;Townsend	city-or-town
Massachusetts;Truro	city-or-town
Massachusetts;Tyngsborough	city-or-town
Massachusetts;Tyringham	city-or-town
Massachusetts;Upton	city-or-town
Massachusetts;Uxbridge	city-or-town
Massachusetts;W. Boylston	city-or-town
Massachusetts;W. Bridgewater	city-or-town
Massachusetts;W. Brookfield	city-or-town
Massachusetts;W. Newbury	city-or-town
Massachusetts;W. Springfield	city-or-town
Massachusetts;W. Stockbridge	city-or-town
Massachusetts;W. Tisbury	city-or-town
Massachusetts;Wakefield	city-or-town
Massachusetts;Wales	city-or-town
Massachusetts;Walpole	city-or-town
Massachusetts;Waltham	city-or-town
Massachusetts;Ware	city-or-town
Massachusetts;Wareham	city-or-town
Massachusetts;Warren	city-or-town
Massachusetts;Warwick	city-or-town
Massachusetts;Washington	city-or-town
Massachusetts;Watertown	city-or-town
Massachusetts;Wayland	city-or-town
Massachusetts;Webster	city-or-town
Massachusetts;Wellesley	city-or-town
Massachusetts;Wellfleet	city-or-town
Massachusetts;Wendell	city-or-town
Massachusetts;Wenham	city-or-town
Massachusetts;Westborough	city-or-town
Massachusetts;Westfield	city-or-town
Massachusetts;Westford	city-or-town
Massachusetts;Westhampton	city-or-town
Massachusetts;Westminster	city-or-town
Massachusetts;Weston	city-or-town
Massachusetts;Westport	city-or-town
Massachusetts;Westwood	city-or-town
Massachusetts;Weymouth	city-or-town
Massachusetts;Whately	city-or-town
Massachusetts;Whitman	city-or-town
Massachusetts;Wilbraham	city-or-town
Massachusetts;Williamsburg	city-or-town
Massachusetts;Williamstown	city-or-town
Massachusetts;Wilmington	city-or-town
Massachusetts;Winchendon	city-or-town
Massachusetts;Winchester	city-or-town
Massachusetts;Windsor	city-or-town
Massachusetts;Winthrop	city-or-town
Massachusetts;Woburn	city-or-town
Massachusetts;Worcester	city-or-town
Massachusetts;Worthington	city-or-town
Massachusetts;Wrentham	city-or-town
Massachusetts;Yarmouth	city-or-town
