Name	ReportingUnitType
Minnesota;MN House District 1	state-house
Minnesota;MN House District 1A	state-house
Minnesota;MN House District 1B	state-houseMinnesota;MN House District 2	state-house
Minnesota;MN House District 3	state-house
Minnesota;MN House District 3A	state-house
Minnesota;MN House District 3B	state-houseMinnesota;MN House District 4	state-house
Minnesota;MN House District 5	state-house
Minnesota;MN House District 5A	state-house
Minnesota;MN House District 5B	state-houseMinnesota;MN House District 6	state-house
Minnesota;MN House District 7	state-house
Minnesota;MN House District 7A	state-house
Minnesota;MN House District 7B	state-houseMinnesota;MN House District 8	state-house
Minnesota;MN House District 9	state-house
Minnesota;MN House District 9A	state-house
Minnesota;MN House District 9B	state-houseMinnesota;MN House District 10	state-house
Minnesota;MN House District 11	state-house
Minnesota;MN House District 11A	state-house
Minnesota;MN House District 11B	state-houseMinnesota;MN House District 12	state-house
Minnesota;MN House District 13	state-house
Minnesota;MN House District 13A	state-house
Minnesota;MN House District 13B	state-houseMinnesota;MN House District 14	state-house
Minnesota;MN House District 15	state-house
Minnesota;MN House District 15A	state-house
Minnesota;MN House District 15B	state-houseMinnesota;MN House District 16	state-house
Minnesota;MN House District 17	state-house
Minnesota;MN House District 17A	state-house
Minnesota;MN House District 17B	state-houseMinnesota;MN House District 18	state-house
Minnesota;MN House District 19	state-house
Minnesota;MN House District 19A	state-house
Minnesota;MN House District 19B	state-houseMinnesota;MN House District 20	state-house
Minnesota;MN House District 21	state-house
Minnesota;MN House District 21A	state-house
Minnesota;MN House District 21B	state-houseMinnesota;MN House District 22	state-house
Minnesota;MN House District 23	state-house
Minnesota;MN House District 23A	state-house
Minnesota;MN House District 23B	state-houseMinnesota;MN House District 24	state-house
Minnesota;MN House District 25	state-house
Minnesota;MN House District 25A	state-house
Minnesota;MN House District 25B	state-houseMinnesota;MN House District 26	state-house
Minnesota;MN House District 27	state-house
Minnesota;MN House District 27A	state-house
Minnesota;MN House District 27B	state-houseMinnesota;MN House District 28	state-house
Minnesota;MN House District 29	state-house
Minnesota;MN House District 29A	state-house
Minnesota;MN House District 29B	state-houseMinnesota;MN House District 30	state-house
Minnesota;MN House District 31	state-house
Minnesota;MN House District 31A	state-house
Minnesota;MN House District 31B	state-houseMinnesota;MN House District 32	state-house
Minnesota;MN House District 33	state-house
Minnesota;MN House District 33A	state-house
Minnesota;MN House District 33B	state-houseMinnesota;MN House District 34	state-house
Minnesota;MN House District 35	state-house
Minnesota;MN House District 35A	state-house
Minnesota;MN House District 35B	state-houseMinnesota;MN House District 36	state-house
Minnesota;MN House District 37	state-house
Minnesota;MN House District 37A	state-house
Minnesota;MN House District 37B	state-houseMinnesota;MN House District 38	state-house
Minnesota;MN House District 39	state-house
Minnesota;MN House District 39A	state-house
Minnesota;MN House District 39B	state-houseMinnesota;MN House District 40	state-house
Minnesota;MN House District 41	state-house
Minnesota;MN House District 41A	state-house
Minnesota;MN House District 41B	state-houseMinnesota;MN House District 42	state-house
Minnesota;MN House District 43	state-house
Minnesota;MN House District 43A	state-house
Minnesota;MN House District 43B	state-houseMinnesota;MN House District 44	state-house
Minnesota;MN House District 45	state-house
Minnesota;MN House District 45A	state-house
Minnesota;MN House District 45B	state-houseMinnesota;MN House District 46	state-house
Minnesota;MN House District 47	state-house
Minnesota;MN House District 47A	state-house
Minnesota;MN House District 47B	state-houseMinnesota;MN House District 48	state-house
Minnesota;MN House District 49	state-house
Minnesota;MN House District 49A	state-house
Minnesota;MN House District 49B	state-houseMinnesota;MN House District 50	state-house
Minnesota;MN House District 51	state-house
Minnesota;MN House District 51A	state-house
Minnesota;MN House District 51B	state-houseMinnesota;MN House District 52	state-house
Minnesota;MN House District 53	state-house
Minnesota;MN House District 53A	state-house
Minnesota;MN House District 53B	state-houseMinnesota;MN House District 54	state-house
Minnesota;MN House District 55	state-house
Minnesota;MN House District 55A	state-house
Minnesota;MN House District 55B	state-houseMinnesota;MN House District 56	state-house
Minnesota;MN House District 57	state-house
Minnesota;MN House District 57A	state-house
Minnesota;MN House District 57B	state-houseMinnesota;MN House District 58	state-house
Minnesota;MN House District 59	state-house
Minnesota;MN House District 59A	state-house
Minnesota;MN House District 59B	state-houseMinnesota;MN House District 60	state-house
Minnesota;MN House District 61	state-house
Minnesota;MN House District 61A	state-house
Minnesota;MN House District 61B	state-houseMinnesota;MN House District 62	state-house
Minnesota;MN House District 63	state-house
Minnesota;MN House District 63A	state-house
Minnesota;MN House District 63B	state-houseMinnesota;MN House District 64	state-house
Minnesota;MN House District 65	state-house
Minnesota;MN House District 65A	state-house
Minnesota;MN House District 65B	state-houseMinnesota;MN House District 66	state-house
Minnesota;MN House District 67	state-house
Minnesota;MN House District 67A	state-house
Minnesota;MN House District 67B	state-houseMinnesota;MN House District 68	state-house
Minnesota;MN House District 69	state-house
Minnesota;MN House District 69A	state-house
Minnesota;MN House District 69B	state-houseMinnesota;MN House District 70	state-house
Minnesota;MN House District 71	state-house
Minnesota;MN House District 71A	state-house
Minnesota;MN House District 71B	state-houseMinnesota;MN House District 72	state-house
Minnesota;MN House District 73	state-house
Minnesota;MN House District 73A	state-house
Minnesota;MN House District 73B	state-houseMinnesota;MN House District 74	state-house
Minnesota;MN House District 75	state-house
Minnesota;MN House District 75A	state-house
Minnesota;MN House District 75B	state-houseMinnesota;MN House District 76	state-house
Minnesota;MN House District 77	state-house
Minnesota;MN House District 77A	state-house
Minnesota;MN House District 77B	state-houseMinnesota;MN House District 78	state-house
Minnesota;MN House District 79	state-house
Minnesota;MN House District 79A	state-house
Minnesota;MN House District 79B	state-houseMinnesota;MN House District 80	state-house
Minnesota;MN House District 81	state-house
Minnesota;MN House District 81A	state-house
Minnesota;MN House District 81B	state-houseMinnesota;MN House District 82	state-house
Minnesota;MN House District 83	state-house
Minnesota;MN House District 83A	state-house
Minnesota;MN House District 83B	state-houseMinnesota;MN House District 84	state-house
Minnesota;MN House District 85	state-house
Minnesota;MN House District 85A	state-house
Minnesota;MN House District 85B	state-houseMinnesota;MN House District 86	state-house
Minnesota;MN House District 87	state-house
Minnesota;MN House District 87A	state-house
Minnesota;MN House District 87B	state-houseMinnesota;MN House District 88	state-house
Minnesota;MN House District 89	state-house
Minnesota;MN House District 89A	state-house
Minnesota;MN House District 89B	state-houseMinnesota;MN House District 90	state-house
Minnesota;MN House District 91	state-house
Minnesota;MN House District 91A	state-house
Minnesota;MN House District 91B	state-houseMinnesota;MN House District 92	state-house
Minnesota;MN House District 93	state-house
Minnesota;MN House District 93A	state-house
Minnesota;MN House District 93B	state-houseMinnesota;MN House District 94	state-house
Minnesota;MN House District 95	state-house
Minnesota;MN House District 95A	state-house
Minnesota;MN House District 95B	state-houseMinnesota;MN House District 96	state-house
Minnesota;MN House District 97	state-house
Minnesota;MN House District 97A	state-house
Minnesota;MN House District 97B	state-houseMinnesota;MN House District 98	state-house
Minnesota;MN House District 99	state-house
Minnesota;MN House District 99A	state-house
Minnesota;MN House District 99B	state-houseMinnesota;MN House District 100	state-house
Minnesota;MN House District 101	state-house
Minnesota;MN House District 101A	state-house
Minnesota;MN House District 101B	state-houseMinnesota;MN House District 102	state-house
Minnesota;MN House District 103	state-house
Minnesota;MN House District 103A	state-house
Minnesota;MN House District 103B	state-houseMinnesota;MN House District 104	state-house
Minnesota;MN House District 105	state-house
Minnesota;MN House District 105A	state-house
Minnesota;MN House District 105B	state-houseMinnesota;MN House District 106	state-house
Minnesota;MN House District 107	state-house
Minnesota;MN House District 107A	state-house
Minnesota;MN House District 107B	state-houseMinnesota;MN House District 108	state-house
Minnesota;MN House District 109	state-house
Minnesota;MN House District 109A	state-house
Minnesota;MN House District 109B	state-houseMinnesota;MN House District 110	state-house
Minnesota;MN House District 111	state-house
Minnesota;MN House District 111A	state-house
Minnesota;MN House District 111B	state-houseMinnesota;MN House District 112	state-house
Minnesota;MN House District 113	state-house
Minnesota;MN House District 113A	state-house
Minnesota;MN House District 113B	state-houseMinnesota;MN House District 114	state-house
Minnesota;MN House District 115	state-house
Minnesota;MN House District 115A	state-house
Minnesota;MN House District 115B	state-houseMinnesota;MN House District 116	state-house
Minnesota;MN House District 117	state-house
Minnesota;MN House District 117A	state-house
Minnesota;MN House District 117B	state-houseMinnesota;MN House District 118	state-house
Minnesota;MN House District 119	state-house
Minnesota;MN House District 119A	state-house
Minnesota;MN House District 119B	state-houseMinnesota;MN House District 120	state-house
Minnesota;MN House District 121	state-house
Minnesota;MN House District 121A	state-house
Minnesota;MN House District 121B	state-houseMinnesota;MN House District 122	state-house
Minnesota;MN House District 123	state-house
Minnesota;MN House District 123A	state-house
Minnesota;MN House District 123B	state-houseMinnesota;MN House District 124	state-house
Minnesota;MN House District 125	state-house
Minnesota;MN House District 125A	state-house
Minnesota;MN House District 125B	state-houseMinnesota;MN House District 126	state-house
Minnesota;MN House District 127	state-house
Minnesota;MN House District 127A	state-house
Minnesota;MN House District 127B	state-houseMinnesota;MN House District 128	state-house
Minnesota;MN House District 129	state-house
Minnesota;MN House District 129A	state-house
Minnesota;MN House District 129B	state-houseMinnesota;MN House District 130	state-house
Minnesota;MN House District 131	state-house
Minnesota;MN House District 131A	state-house
Minnesota;MN House District 131B	state-houseMinnesota;MN House District 132	state-house
Minnesota;MN House District 133	state-house
Minnesota;MN House District 133A	state-house
Minnesota;MN House District 133B	state-houseMinnesota;MN House District 134	state-house
Minnesota;MN Senate District 1	state-senate
Minnesota;MN Senate District 2	state-senate
Minnesota;MN Senate District 3	state-senate
Minnesota;MN Senate District 4	state-senate
Minnesota;MN Senate District 5	state-senate
Minnesota;MN Senate District 6	state-senate
Minnesota;MN Senate District 7	state-senate
Minnesota;MN Senate District 8	state-senate
Minnesota;MN Senate District 9	state-senate
Minnesota;MN Senate District 10	state-senate
Minnesota;MN Senate District 11	state-senate
Minnesota;MN Senate District 12	state-senate
Minnesota;MN Senate District 13	state-senate
Minnesota;MN Senate District 14	state-senate
Minnesota;MN Senate District 15	state-senate
Minnesota;MN Senate District 16	state-senate
Minnesota;MN Senate District 17	state-senate
Minnesota;MN Senate District 18	state-senate
Minnesota;MN Senate District 19	state-senate
Minnesota;MN Senate District 20	state-senate
Minnesota;MN Senate District 21	state-senate
Minnesota;MN Senate District 22	state-senate
Minnesota;MN Senate District 23	state-senate
Minnesota;MN Senate District 24	state-senate
Minnesota;MN Senate District 25	state-senate
Minnesota;MN Senate District 26	state-senate
Minnesota;MN Senate District 27	state-senate
Minnesota;MN Senate District 28	state-senate
Minnesota;MN Senate District 29	state-senate
Minnesota;MN Senate District 30	state-senate
Minnesota;MN Senate District 31	state-senate
Minnesota;MN Senate District 32	state-senate
Minnesota;MN Senate District 33	state-senate
Minnesota;MN Senate District 34	state-senate
Minnesota;MN Senate District 35	state-senate
Minnesota;MN Senate District 36	state-senate
Minnesota;MN Senate District 37	state-senate
Minnesota;MN Senate District 38	state-senate
Minnesota;MN Senate District 39	state-senate
Minnesota;MN Senate District 40	state-senate
Minnesota;MN Senate District 41	state-senate
Minnesota;MN Senate District 42	state-senate
Minnesota;MN Senate District 43	state-senate
Minnesota;MN Senate District 44	state-senate
Minnesota;MN Senate District 45	state-senate
Minnesota;MN Senate District 46	state-senate
Minnesota;MN Senate District 47	state-senate
Minnesota;MN Senate District 48	state-senate
Minnesota;MN Senate District 49	state-senate
Minnesota;MN Senate District 50	state-senate
Minnesota;MN Senate District 51	state-senate
Minnesota;MN Senate District 52	state-senate
Minnesota;MN Senate District 53	state-senate
Minnesota;MN Senate District 54	state-senate
Minnesota;MN Senate District 55	state-senate
Minnesota;MN Senate District 56	state-senate
Minnesota;MN Senate District 57	state-senate
Minnesota;MN Senate District 58	state-senate
Minnesota;MN Senate District 59	state-senate
Minnesota;MN Senate District 60	state-senate
Minnesota;MN Senate District 61	state-senate
Minnesota;MN Senate District 62	state-senate
Minnesota;MN Senate District 63	state-senate
Minnesota;MN Senate District 64	state-senate
Minnesota;MN Senate District 65	state-senate
Minnesota;MN Senate District 66	state-senate
Minnesota;MN Senate District 67	state-senate
Minnesota;US House MN District 1	congressional
Minnesota;US House MN District 2	congressional
Minnesota;US House MN District 3	congressional
Minnesota;US House MN District 4	congressional
Minnesota;US House MN District 5	congressional
Minnesota;US House MN District 6	congressional
Minnesota;US House MN District 7	congressional
Minnesota;US House MN District 8	congressional
Minnesota	state
Aitkin County	county
Anoka County	county
Becker County	county
Beltrami County	county
Benton County	county
Big Stone County	county
Blue Earth County	county
Brown County	county
Carlton County	county
Carver County	county
Cass County	county
Chippewa County	county
Chisago County	county
Clay County	county
Clearwater County	county
Cook County	county
Cottonwood County	county
Crow Wing County	county
Dakota County	county
Dodge County	county
Douglas County	county
Faribault County	county
Fillmore County	county
Freeborn County	county
Goodhue County	county
Grant County	county
Hennepin County	county
Houston County	county
Hubbard County	county
Isanti County	county
Itasca County	county
Jackson County	county
Kanabec County	county
Kandiyohi County	county
Kittson County	county
Koochiching County	county
Lac Qui Parle County	county
Lake County	county
Lake Of The Woods County	county
Le Sueur County	county
Lincoln County	county
Lyon County	county
Mcleod County	county
Mahnomen County	county
Marshall County	county
Martin County	county
Meeker County	county
Mille Lacs County	county
Morrison County	county
Mower County	county
Murray County	county
Nicollet County	county
Nobles County	county
Norman County	county
Olmsted County	county
Otter Tail County	county
Pennington County	county
Pine County	county
Pipestone County	county
Polk County	county
Pope County	county
Ramsey County	county
Red Lake County	county
Redwood County	county
Renville County	county
Rice County	county
Rock County	county
Roseau County	county
St. Louis County	county
Scott County	county
Sherburne County	county
Sibley County	county
Stearns County	county
Steele County	county
Stevens County	county
Swift County	county
Todd County	county
Traverse County	county
Wabasha County	county
Wadena County	county
Waseca County	county
Washington County	county
Watonwan County	county
Wilkin County	county
Winona County	county
Wright County	county
Yellow Medicine County	county
