Name	ReportingUnitType
Wisconsin	State
Wisconsin;Adams County	county
Wisconsin;Ashland County	county
Wisconsin;Barron County	county
Wisconsin;Bayfield County	county
Wisconsin;Brown County	county
Wisconsin;Buffalo County	county
Wisconsin;Burnett County	county
Wisconsin;Calumet County	county
Wisconsin;Chippewa County	county
Wisconsin;Clark County	county
Wisconsin;Columbia County	county
Wisconsin;Crawford County	county
Wisconsin;Dane County	county
Wisconsin;Dodge County	county
Wisconsin;Door County	county
Wisconsin;Douglas County	county
Wisconsin;Dunn County	county
Wisconsin;Eau Claire County	county
Wisconsin;Florence County	county
Wisconsin;Fond du Lac County	county
Wisconsin;Forest County	county
Wisconsin;Grant County	county
Wisconsin;Green County	county
Wisconsin;Green Lake County	county
Wisconsin;Iowa County	county
Wisconsin;Iron County	county
Wisconsin;Jackson County	county
Wisconsin;Jefferson County	county
Wisconsin;Juneau County	county
Wisconsin;Kenosha County	county
Wisconsin;Kewaunee County	county
Wisconsin;La Crosse County	county
Wisconsin;Lafayette County	county
Wisconsin;Langlade County	county
Wisconsin;Lincoln County	county
Wisconsin;Manitowoc County	county
Wisconsin;Marathon County	county
Wisconsin;Marinette County	county
Wisconsin;Marquette County	county
Wisconsin;Menominee County	county
Wisconsin;Milwaukee County	county
Wisconsin;Monroe County	county
Wisconsin;Oconto County	county
Wisconsin;Oneida County	county
Wisconsin;Outagamie County	county
Wisconsin;Ozaukee County	county
Wisconsin;Pepin County	county
Wisconsin;Pierce County	county
Wisconsin;Polk County	county
Wisconsin;Portage County	county
Wisconsin;Price County	county
Wisconsin;Racine County	county
Wisconsin;Richland County	county
Wisconsin;Rock County	county
Wisconsin;Rusk County	county
Wisconsin;Sauk County	county
Wisconsin;Sawyer County	county
Wisconsin;Shawano County	county
Wisconsin;Sheboygan County	county
Wisconsin;St. Croix County	county
Wisconsin;Taylor County	county
Wisconsin;Trempealeau County	county
Wisconsin;US House WI District 1	congressional
Wisconsin;US House WI District 2	congressional
Wisconsin;US House WI District 3	congressional
Wisconsin;US House WI District 4	congressional
Wisconsin;US House WI District 5	congressional
Wisconsin;US House WI District 6	congressional
Wisconsin;US House WI District 7	congressional
Wisconsin;US House WI District 8	congressional
Wisconsin;Vernon County	county
Wisconsin;Vilas County	county
Wisconsin;WI House District 1	state-house
Wisconsin;WI House District 10	state-house
Wisconsin;WI House District 11	state-house
Wisconsin;WI House District 12	state-house
Wisconsin;WI House District 13	state-house
Wisconsin;WI House District 14	state-house
Wisconsin;WI House District 15	state-house
Wisconsin;WI House District 16	state-house
Wisconsin;WI House District 17	state-house
Wisconsin;WI House District 18	state-house
Wisconsin;WI House District 19	state-house
Wisconsin;WI House District 2	state-house
Wisconsin;WI House District 20	state-house
Wisconsin;WI House District 21	state-house
Wisconsin;WI House District 22	state-house
Wisconsin;WI House District 23	state-house
Wisconsin;WI House District 24	state-house
Wisconsin;WI House District 25	state-house
Wisconsin;WI House District 26	state-house
Wisconsin;WI House District 27	state-house
Wisconsin;WI House District 28	state-house
Wisconsin;WI House District 29	state-house
Wisconsin;WI House District 3	state-house
Wisconsin;WI House District 30	state-house
Wisconsin;WI House District 31	state-house
Wisconsin;WI House District 32	state-house
Wisconsin;WI House District 33	state-house
Wisconsin;WI House District 34	state-house
Wisconsin;WI House District 35	state-house
Wisconsin;WI House District 36	state-house
Wisconsin;WI House District 37	state-house
Wisconsin;WI House District 38	state-house
Wisconsin;WI House District 39	state-house
Wisconsin;WI House District 4	state-house
Wisconsin;WI House District 40	state-house
Wisconsin;WI House District 41	state-house
Wisconsin;WI House District 42	state-house
Wisconsin;WI House District 43	state-house
Wisconsin;WI House District 44	state-house
Wisconsin;WI House District 45	state-house
Wisconsin;WI House District 46	state-house
Wisconsin;WI House District 47	state-house
Wisconsin;WI House District 48	state-house
Wisconsin;WI House District 49	state-house
Wisconsin;WI House District 5	state-house
Wisconsin;WI House District 50	state-house
Wisconsin;WI House District 51	state-house
Wisconsin;WI House District 52	state-house
Wisconsin;WI House District 53	state-house
Wisconsin;WI House District 54	state-house
Wisconsin;WI House District 55	state-house
Wisconsin;WI House District 56	state-house
Wisconsin;WI House District 57	state-house
Wisconsin;WI House District 58	state-house
Wisconsin;WI House District 59	state-house
Wisconsin;WI House District 6	state-house
Wisconsin;WI House District 60	state-house
Wisconsin;WI House District 61	state-house
Wisconsin;WI House District 62	state-house
Wisconsin;WI House District 63	state-house
Wisconsin;WI House District 64	state-house
Wisconsin;WI House District 65	state-house
Wisconsin;WI House District 66	state-house
Wisconsin;WI House District 67	state-house
Wisconsin;WI House District 68	state-house
Wisconsin;WI House District 69	state-house
Wisconsin;WI House District 7	state-house
Wisconsin;WI House District 70	state-house
Wisconsin;WI House District 71	state-house
Wisconsin;WI House District 72	state-house
Wisconsin;WI House District 73	state-house
Wisconsin;WI House District 74	state-house
Wisconsin;WI House District 75	state-house
Wisconsin;WI House District 76	state-house
Wisconsin;WI House District 77	state-house
Wisconsin;WI House District 78	state-house
Wisconsin;WI House District 79	state-house
Wisconsin;WI House District 8	state-house
Wisconsin;WI House District 80	state-house
Wisconsin;WI House District 81	state-house
Wisconsin;WI House District 82	state-house
Wisconsin;WI House District 83	state-house
Wisconsin;WI House District 84	state-house
Wisconsin;WI House District 85	state-house
Wisconsin;WI House District 86	state-house
Wisconsin;WI House District 87	state-house
Wisconsin;WI House District 88	state-house
Wisconsin;WI House District 89	state-house
Wisconsin;WI House District 9	state-house
Wisconsin;WI House District 90	state-house
Wisconsin;WI House District 91	state-house
Wisconsin;WI House District 92	state-house
Wisconsin;WI House District 93	state-house
Wisconsin;WI House District 94	state-house
Wisconsin;WI House District 95	state-house
Wisconsin;WI House District 96	state-house
Wisconsin;WI House District 97	state-house
Wisconsin;WI House District 98	state-house
Wisconsin;WI House District 99	state-house
Wisconsin;WI Senate District 1	state-senate
Wisconsin;WI Senate District 10	state-senate
Wisconsin;WI Senate District 11	state-senate
Wisconsin;WI Senate District 12	state-senate
Wisconsin;WI Senate District 13	state-senate
Wisconsin;WI Senate District 14	state-senate
Wisconsin;WI Senate District 15	state-senate
Wisconsin;WI Senate District 16	state-senate
Wisconsin;WI Senate District 17	state-senate
Wisconsin;WI Senate District 18	state-senate
Wisconsin;WI Senate District 19	state-senate
Wisconsin;WI Senate District 2	state-senate
Wisconsin;WI Senate District 20	state-senate
Wisconsin;WI Senate District 21	state-senate
Wisconsin;WI Senate District 22	state-senate
Wisconsin;WI Senate District 23	state-senate
Wisconsin;WI Senate District 24	state-senate
Wisconsin;WI Senate District 25	state-senate
Wisconsin;WI Senate District 26	state-senate
Wisconsin;WI Senate District 27	state-senate
Wisconsin;WI Senate District 28	state-senate
Wisconsin;WI Senate District 29	state-senate
Wisconsin;WI Senate District 3	state-senate
Wisconsin;WI Senate District 30	state-senate
Wisconsin;WI Senate District 31	state-senate
Wisconsin;WI Senate District 32	state-senate
Wisconsin;WI Senate District 33	state-senate
Wisconsin;WI Senate District 4	state-senate
Wisconsin;WI Senate District 5	state-senate
Wisconsin;WI Senate District 6	state-senate
Wisconsin;WI Senate District 7	state-senate
Wisconsin;WI Senate District 8	state-senate
Wisconsin;WI Senate District 9	state-senate
Wisconsin;Walworth County	county
Wisconsin;Washburn County	county
Wisconsin;Washington County	county
Wisconsin;Waukesha County	county
Wisconsin;Waupaca County	county
Wisconsin;Waushara County	county
Wisconsin;Winnebago County	county
Wisconsin;Wood County	county
Town of ADAMS Wards 1-3	town
Town of BIG FLATS Wards 1-2	town
Town of COLBURN Ward 1	town
Town of DELL PRAIRIE Wards 1-3	town
Town of EASTON Wards 1-2	town
Town of JACKSON Wards 1-2	town
Town of LEOLA Ward 1	town
Town of LINCOLN Ward 1	town
Town of MONROE Ward 1	town
Town of NEW CHESTER Wards 1-3	town
Town of NEW HAVEN Ward 1	town
Town of PRESTON Wards 1-2	town
Town of QUINCY Wards 1-3	town
Town of RICHFIELD Ward 1	town
Town of ROME Wards 1-5	town
Town of SPRINGVILLE Wards 1-2	town
Town of STRONGS PRAIRIE Wards 1-3	town
Village of FRIENDSHIP Ward 1	town
City of ADAMS Wards 1-4	town
CITY OF WISCONSIN DELLS Wards 5,9	town
Town of AGENDA Ward 1	town
Town of ASHLAND Ward 1	town
Town of CHIPPEWA Ward 1	town
Town of GINGLES Ward 1	town
Town of GORDON Wards 1-2	town
Town of JACOBS Ward 1	town
Town of LA POINTE Ward 1	town
Town of MARENGO Wards 1-2	town
Town of MORSE Wards 1-3	town
Town of PEEKSVILLE Wards 1-2	town
Town of SANBORN Wards 1-2	town
Town of SHANAGOLDEN Ward 1	town
Town of WHITE RIVER Wards 1-2	town
Village of BUTTERNUT Wards 1-2	town
City of ASHLAND Wards 1-5	town
City of ASHLAND Wards 6-11	town
City of MELLEN Ward 1	town
Town of ALMENA Wards 1-2	town
Town of ARLAND Ward 1	town
Town of BARRON Wards 1-2	town
Town of BEAR LAKE Ward 1	town
Town of CEDAR LAKE Ward 1	town
Town of CHETEK Wards 1-2	town
Town of CLINTON Ward 1	town
Town of CRYSTAL LAKE Ward 1	town
Town of CUMBERLAND Ward 1	town
Town of DALLAS Ward 1	town
Town of DOVRE Ward 1	town
Town of DOYLE Wards 1-2	town
Town of LAKELAND Wards 1-2	town
Town of MAPLE GROVE Wards 1-2	town
Town of MAPLE PLAIN Ward 1	town
Town of OAK GROVE Wards 1-2	town
Town of PRAIRIE FARM Wards 1-2	town
Town of PRAIRIE LAKE Wards 1-2	town
Town of RICE LAKE Wards 1-4	town
Town of SIOUX CREEK Ward 1	town
Town of STANFOLD Ward 1	town
Town of STANLEY Wards 1-4	town
Town of SUMNER Ward 1	town
Town of TURTLE LAKE Ward 1	town
Town of VANCE CREEK Ward 1	town
Village of ALMENA Ward 1	town
Village of CAMERON Wards 1-3	town
Village of DALLAS Ward 1	town
Village of HAUGEN Ward 1	town
VILLAGE OF NEW AUBURN Ward 2	town
VILLAGE OF NEW AUBURN Ward 3	town
Village of PRAIRIE FARM Ward 1	town
Village of TURTLE LAKE Ward 1	town
City of BARRON Wards 1-7	town
City of CHETEK Wards 1-4	town
City of CUMBERLAND Wards 1-4	town
City of RICE LAKE Wards 1-13	town
Town of BARKSDALE Ward 1	town
Town of BARNES Ward 1	town
Town of BAYFIELD Ward 1	town
Town of BAYVIEW Ward 1	town
Town of BELL Ward 1	town
Town of CABLE Ward 1	town
Town of CLOVER Ward 1	town
Town of DELTA Ward 1	town
Town of DRUMMOND Ward 1	town
Town of EILEEN Wards 1-2	town
Town of GRAND VIEW Ward 1	town
Town of HUGHES Ward 1	town
Town of IRON RIVER Wards 1-2	town
Town of KELLY Ward 1	town
Town of KEYSTONE Ward 1	town
Town of MASON Ward 1	town
Town of NAMAKAGON Ward 1	town
Town of ORIENTA Ward 1	town
Town of OULU Ward 1	town
Town of PILSEN Ward 1	town
Town of PORT WING Ward 1	town
Town of RUSSELL Wards 1-2	town
Town of TRIPP Ward 1	town
Town of WASHBURN Ward 1	town
Village of MASON Ward 1	town
CITY OF ASHLAND Ward 12	town
City of BAYFIELD Wards 1-4	town
City of WASHBURN Wards 1-4	town
Town of EATON Wards 1-2	town
Town of GLENMORE Wards 1-2	town
Town of GREEN BAY Wards 1-3	town
Town of HOLLAND Wards 1-2	town
Town of HUMBOLDT Wards 1-2	town
Town of LAWRENCE Wards 1-6	town
Town of LEDGEVIEW Wards 1-3,8-10	town
Town of LEDGEVIEW Wards 4-7	town
Town of MORRISON Wards 1-2	town
Town of NEW DENMARK Wards 1-3	town
Town of PITTSFIELD Wards 1-3	town
Town of ROCKLAND Wards 1-3	town
Town of SCOTT Wards 1-4	town
Town of WRIGHTSTOWN Wards 1-3	town
Village of ALLOUEZ Wards 1-2	town
Village of ALLOUEZ Wards 3-4	town
Village of ALLOUEZ Wards 5-6	town
Village of ALLOUEZ Wards 7-9	town
Village of ALLOUEZ Ward 10	town
Village of ASHWAUBENON Wards 1-2	town
Village of ASHWAUBENON Wards 3-4	town
Village of ASHWAUBENON Wards 5-6	town
Village of ASHWAUBENON Wards 7-8	town
Village of ASHWAUBENON Wards 9-10	town
Village of ASHWAUBENON Wards 11-12	town
Village of BELLEVUE Wards 1-6	town
Village of BELLEVUE Wards 7-10	town
Village of DENMARK Wards 1-4	town
Village of HOBART Wards 1-8	town
Village of HOBART Ward 9	town
Village of HOWARD Wards 1,12-14	town
Village of HOWARD Wards 2,9-11,18	town
Village of HOWARD Wards 3-4,6	town
Village of HOWARD Ward 5	town
Village of HOWARD Ward 7	town
Village of HOWARD Ward 8	town
Village of HOWARD Wards 15-16	town
Village of PULASKI Wards 1-3,6	town
Village of SUAMICO Wards 1-4	town
Village of SUAMICO Wards 5-8	town
Village of WRIGHTSTOWN Wards 1-3	town
City of DE PERE Wards 1-4	town
City of DE PERE Ward 5	town
City of DE PERE Wards 6-8	town
City of DE PERE Wards 9,18	town
City of DE PERE Wards 10-12	town
City of DE PERE Wards 13-15	town
City of DE PERE Wards 16-17	town
City of GREEN BAY Ward 1	town
City of GREEN BAY Ward 2	town
City of GREEN BAY Ward 3	town
City of GREEN BAY Ward 4	town
City of GREEN BAY Ward 5	town
City of GREEN BAY Ward 6	town
City of GREEN BAY Ward 7	town
City of GREEN BAY Ward 8	town
City of GREEN BAY Ward 9	town
City of GREEN BAY Ward 10	town
City of GREEN BAY Ward 11	town
City of GREEN BAY Ward 12	town
City of GREEN BAY Ward 13	town
City of GREEN BAY Ward 14	town
City of GREEN BAY Ward 15	town
City of GREEN BAY Ward 16	town
City of GREEN BAY Ward 17	town
City of GREEN BAY Ward 18	town
City of GREEN BAY Ward 19	town
City of GREEN BAY Ward 20	town
City of GREEN BAY Ward 21	town
City of GREEN BAY Ward 22	town
City of GREEN BAY Ward 23	town
City of GREEN BAY Ward 24	town
City of GREEN BAY Ward 25	town
City of GREEN BAY Ward 26	town
City of GREEN BAY Ward 27	town
City of GREEN BAY Ward 28	town
City of GREEN BAY Ward 29	town
City of GREEN BAY Ward 30	town
City of GREEN BAY Ward 31	town
City of GREEN BAY Ward 32	town
City of GREEN BAY Ward 33	town
City of GREEN BAY Ward 34	town
City of GREEN BAY Ward 35	town
City of GREEN BAY Ward 36	town
City of GREEN BAY Ward 37	town
City of GREEN BAY Ward 38	town
City of GREEN BAY Ward 39	town
City of GREEN BAY Ward 40	town
City of GREEN BAY Ward 41	town
City of GREEN BAY Ward 42	town
City of GREEN BAY Ward 43	town
City of GREEN BAY Ward 44	town
City of GREEN BAY Ward 45	town
City of GREEN BAY Ward 46	town
City of GREEN BAY Ward 47	town
Town of ALMA Ward 1	town
Town of BELVIDERE Ward 1	town
Town of BUFFALO Ward 1	town
Town of CANTON Ward 1	town
Town of CROSS Ward 1	town
Town of DOVER Ward 1	town
Town of GILMANTON Ward 1	town
Town of GLENCOE Ward 1	town
Town of MAXVILLE Ward 1	town
Town of MILTON Ward 1	town
Town of MODENA Ward 1	town
Town of MONDOVI Ward 1	town
Town of MONTANA Ward 1	town
Town of NAPLES Ward 1	town
Town of NELSON Ward 1	town
Town of WAUMANDEE Ward 1	town
Village of COCHRANE Ward 1	town
Village of NELSON Ward 1	town
City of ALMA Wards 1-2	town
City of BUFFALO CITY Ward 1	town
City of FOUNTAIN CITY Wards 1-2	town
City of MONDOVI Wards 1-3	town
Town of ANDERSON Ward 1	town
Town of BLAINE Ward 1	town
Town of DANIELS Ward 1	town
Town of DEWEY Ward 1	town
Town of GRANTSBURG Wards 1-3	town
Town of JACKSON Ward 1	town
Town of LA FOLLETTE Wards 1-2	town
Town of MEENON Wards 1-3	town
Town of OAKLAND Wards 1-2	town
Town of ROOSEVELT Ward 1	town
Town of RUSK Ward 1	town
Town of SAND LAKE Ward 1	town
Town of SCOTT Wards 1-2	town
Town of SIREN Wards 1-2	town
Town of SWISS Wards 1-2	town
Town of TRADE LAKE Wards 1-2	town
Town of UNION Ward 1	town
Town of WEBB LAKE Ward 1	town
Town of WEST MARSHLAND Wards 1-2	town
Town of WOOD RIVER Wards 1-3	town
Village of GRANTSBURG Wards 1-3	town
Village of SIREN Wards 1-2	town
Village of WEBSTER Wards 1-2	town
Town of BRILLION Wards 1-2	town
Town of BROTHERTOWN Wards 1-2	town
Town of CHARLESTOWN Ward 1	town
Town of CHILTON Wards 1-3	town
Town of NEW HOLSTEIN Wards 1-3	town
Town of RANTOUL Ward 1	town
Town of STOCKBRIDGE Wards 1-3	town
Town of WOODVILLE Ward 1	town
Village of HARRISON Wards 3-4,17-18	town
Village of HARRISON Wards 5-6,10	town
Village of HARRISON Wards 7-9,14-16	town
Village of HARRISON Wards 11-13	town
Village of HILBERT Wards 1-2	town
Village of HILBERT Ward 3	town
Village of POTTER Ward 1	town
Village of SHERWOOD Wards 1-5	town
Village of STOCKBRIDGE Ward 1	town
CITY OF APPLETON Ward 12	town
CITY OF APPLETON Ward 13	town
CITY OF APPLETON Ward 14	town
CITY OF APPLETON Ward 26	town
CITY OF APPLETON Ward 44	town
CITY OF APPLETON Ward 45	town
CITY OF APPLETON Ward 46	town
CITY OF APPLETON Ward 47	town
City of BRILLION Wards 1-5	town
City of CHILTON Wards 1-5	town
CITY OF KAUKAUNA Ward 11	town
CITY OF KIEL Ward 7	town
CITY OF KIEL Ward 10	town
CITY OF MENASHA Wards 16-20	town
City of NEW HOLSTEIN Wards 1-5	town
Town of ANSON Wards 1-3	town
Town of ANSON Ward 4	town
Town of ARTHUR Ward 1	town
Town of AUBURN Ward 1	town
Town of BIRCH CREEK Ward 1	town
Town of BLOOMER Wards 1-2	town
Town of CLEVELAND Ward 1	town
Town of COOKS VALLEY Ward 1	town
Town of DELMAR Ward 1	town
Town of EAGLE POINT Wards 1-5	town
Town of EDSON Wards 1-2	town
Town of ESTELLA Ward 1	town
Town of GOETZ Wards 1-2	town
Town of GOETZ Ward 3	town
Town of HALLIE Ward 1	town
Town of HOWARD Ward 1	town
Town of LAFAYETTE Wards 1-9	town
Town of LAKE HOLCOMBE Wards 1-2	town
Town of RUBY Ward 1	town
Town of SAMPSON Ward 1	town
Town of SIGEL Wards 1-2	town
Town of TILDEN Wards 1-3	town
Town of WHEATON Wards 1-3	town
Town of WOODMOHR Wards 1-2	town
Village of BOYD Ward 1	town
Village of CADOTT Wards 1-3	town
Village of LAKE HALLIE Wards 1-8	town
Village of NEW AUBURN Ward 1	town
City of BLOOMER Wards 1-4	town
City of CHIPPEWA FALLS Ward 1	town
City of CHIPPEWA FALLS Ward 2	town
City of CHIPPEWA FALLS Ward 3	town
City of CHIPPEWA FALLS Ward 3A	town
City of CHIPPEWA FALLS Ward 3B	town
City of CHIPPEWA FALLS Ward 4	town
City of CHIPPEWA FALLS Ward 5	town
City of CHIPPEWA FALLS Ward 5A	town
City of CHIPPEWA FALLS Ward 6	town
City of CHIPPEWA FALLS Ward 7	town
City of CHIPPEWA FALLS Ward 7A	town
City of CORNELL Wards 1-4	town
CITY OF EAU CLAIRE Ward 16	town
CITY OF EAU CLAIRE Ward 40	town
CITY OF EAU CLAIRE Ward 41	town
CITY OF EAU CLAIRE Ward 78	town
City of STANLEY Wards 1-4,6-7	town
Town of BEAVER Ward 1	town
Town of BUTLER Ward 1	town
Town of COLBY Wards 1-3	town
Town of DEWHURST Ward 1	town
Town of FOSTER Ward 1	town
Town of FREMONT Wards 1-2	town
Town of GRANT Wards 1-2	town
Town of GREEN GROVE Wards 1-2	town
Town of HENDREN Ward 1	town
Town of HEWETT Wards 1-2	town
Town of HIXON Wards 1-2	town
Town of HOARD Wards 1-2	town
Town of LEVIS Wards 1-2	town
Town of LONGWOOD Wards 1-2	town
Town of LOYAL Wards 1-2	town
Town of LYNN Wards 1-2	town
Town of MAYVILLE Wards 1-2	town
Town of MEAD Ward 1	town
Town of MENTOR Ward 1	town
Town of PINE VALLEY Wards 1-2	town
Town of RESEBURG Wards 1-2	town
Town of SEIF Ward 1	town
Town of SHERMAN Wards 1-2	town
Town of SHERWOOD Ward 1	town
Town of THORP Ward 1	town
Town of UNITY Ward 1	town
Town of WARNER Wards 1-2	town
Town of WESTON Wards 1-2	town
Town of WITHEE Ward 1	town
Town of WORDEN Ward 1	town
Town of YORK Wards 1-2	town
Village of CURTISS Ward 1	town
Village of DORCHESTER Ward 1	town
Village of GRANTON Ward 1	town
VILLAGE OF UNITY Ward 2	town
Village of WITHEE Ward 1	town
City of ABBOTSFORD Wards 2-5,7	town
City of COLBY Wards 2-4	town
City of GREENWOOD Wards 1-2	town
City of LOYAL Wards 1-2	town
City of NEILLSVILLE Ward 1	town
City of NEILLSVILLE Ward 2	town
City of NEILLSVILLE Ward 3	town
City of NEILLSVILLE Ward 4	town
City of NEILLSVILLE Ward 5	town
City of OWEN Wards 1-3	town
CITY OF STANLEY Ward 5	town
CITY OF STANLEY Ward 8	town
City of THORP Wards 1-4	town
Town of ARLINGTON Ward 1	town
Town of CALEDONIA Wards 1-2	town
Town of COLUMBUS Ward 1	town
Town of COURTLAND Ward 1	town
Town of DEKORRA Wards 1-3	town
Town of FORT WINNEBAGO Ward 1	town
Town of FOUNTAIN PRAIRIE Wards 1-2	town
Town of HAMPDEN Ward 1	town
Town of LEEDS Wards 1-2	town
Town of LEWISTON Wards 1-2	town
Town of LODI Wards 1-5	town
Town of LOWVILLE Wards 1-2	town
Town of MARCELLON Wards 1-2	town
Town of NEWPORT Ward 1	town
Town of OTSEGO Ward 1	town
Town of PACIFIC Wards 1-4	town
Town of RANDOLPH Ward 1	town
Town of SCOTT Ward 1	town
Town of SPRINGVALE Wards 1-2	town
Town of WEST POINT Wards 1-3	town
Town of WYOCENA Wards 1-2	town
Village of ARLINGTON Ward 1	town
Village of CAMBRIA Ward 1	town
Village of DOYLESTOWN Ward 1	town
Village of FALL RIVER Wards 1-2	town
Village of FRIESLAND Ward 1	town
Village of PARDEEVILLE Wards 1-3	town
Village of POYNETTE Wards 1-4	town
VILLAGE OF RANDOLPH Ward 3	town
Village of RIO Wards 1-2	town
Village of WYOCENA Ward 1	town
City of COLUMBUS Wards 1-8	town
City of COLUMBUS Ward 10	town
City of LODI Wards 1-6	town
City of PORTAGE Wards 1,9-10	town
City of PORTAGE Wards 2-3,5	town
City of PORTAGE Wards 4,6-8	town
City of PORTAGE Ward 11	town
City of WISCONSIN DELLS Wards 1-3,6	town
City of WISCONSIN DELLS Wards 11-12	town
Town of BRIDGEPORT Ward 1	town
Town of CLAYTON Wards 1-3	town
Town of EASTMAN Wards 1-2	town
Town of FREEMAN Ward 1	town
Town of HANEY Ward 1	town
Town of MARIETTA Ward 1	town
Town of PRAIRIE DU CHIEN Wards 1-2	town
Town of SENECA Ward 1	town
Town of UTICA Ward 1	town
Town of WAUZEKA Wards 1-2	town
Village of BELL CENTER Ward 1	town
VILLAGE OF DE SOTO Ward 2	town
Village of EASTMAN Ward 1	town
Village of FERRYVILLE Ward 1	town
Village of GAYS MILLS Ward 1	town
Village of LYNXVILLE Ward 1	town
Village of MT. STERLING Ward 1	town
Village of SOLDIERS GROVE Ward 1	town
Village of STEUBEN Ward 1	town
Village of WAUZEKA Ward 1	town
City of PRAIRIE DU CHIEN Ward 1	town
City of PRAIRIE DU CHIEN Wards 2,7	town
City of PRAIRIE DU CHIEN Ward 3	town
City of PRAIRIE DU CHIEN Ward 4	town
City of PRAIRIE DU CHIEN Ward 5	town
City of PRAIRIE DU CHIEN Ward 6	town
Town of ALBION Wards 1-2	town
Town of BERRY Wards 1-2	town
Town of BLACK EARTH Ward 1	town
Town of BLOOMING GROVE Wards 1-3	town
Town of BLUE MOUNDS Ward 1	town
Town of BRISTOL Wards 1-4	town
Town of BURKE Wards 1-4	town
Town of CHRISTIANA Wards 1-2	town
Town of COTTAGE GROVE Wards 1-2,4-5,7	town
Town of COTTAGE GROVE Wards 3,6	town
Town of CROSS PLAINS Wards 1-2	town
Town of CROSS PLAINS Wards 3-4	town
Town of DANE Ward 1	town
Town of DEERFIELD Wards 1-2	town
Town of DUNKIRK Wards 1,3,5	town
Town of DUNKIRK Wards 2,4,6	town
Town of DUNN Wards 1-7	town
Town of MADISON Wards 1-9	town
Town of MAZOMANIE Wards 1-2	town
Town of MEDINA Wards 1-2	town
Town of MIDDLETON Wards 1-8	town
Town of MONTROSE Wards 1-2	town
Town of OREGON Wards 1-4	town
Town of PERRY Ward 1	town
Town of PLEASANT SPRINGS Wards 1-4	town
Town of PRIMROSE Ward 1	town
Town of ROXBURY Wards 1-2	town
Town of RUTLAND Wards 1-2	town
Town of SPRINGDALE Wards 1-2	town
Town of SPRINGFIELD Wards 1-3	town
Town of SUN PRAIRIE Wards 1-3	town
Town of VERMONT Ward 1	town
Town of VERONA Ward 1	town
Town of VERONA Wards 2-4	town
Town of VIENNA Wards 1-2	town
Town of WESTPORT Wards 1-5	town
Town of YORK Ward 1	town
Village of BELLEVILLE Wards 1-2	town
Village of BLACK EARTH Wards 1-2	town
Village of BLUE MOUNDS Ward 1	town
Village of BROOKLYN Ward 1	town
Village of BROOKLYN Ward 3	town
Village of CAMBRIDGE Wards 2-3	town
Village of COTTAGE GROVE Wards 1-10,13	town
Village of COTTAGE GROVE Wards 11-12	town
Village of CROSS PLAINS Wards 1-4	town
Village of CROSS PLAINS Wards 5-6	town
Village of DANE Ward 1	town
Village of DEERFIELD Wards 1-3	town
Village of DEFOREST Wards 1,3-6,15	town
Village of DEFOREST Wards 2,21	town
Village of DEFOREST Wards 7-10,12	town
Village of DEFOREST Wards 11,20	town
Village of DEFOREST Wards 13,19,22-23	town
Village of DEFOREST Wards 14,16-18	town
Village of MAPLE BLUFF Wards 1-2	town
Village of MARSHALL Wards 1-5	town
Village of MAZOMANIE Wards 1-3	town
Village of MCFARLAND Wards 1-13	town
Village of MCFARLAND Ward 14	town
Village of MOUNT HOREB Wards 1-4	town
Village of MOUNT HOREB Wards 5-9	town
Village of OREGON Wards 1,5-6,11,13	town
Village of OREGON Wards 2-4,12	town
Village of OREGON Wards 7-10	town
Village of ROCKDALE Ward 1	town
Village of SHOREWOOD HILLS Wards 1-2	town
Village of WAUNAKEE Wards 1-5	town
Village of WAUNAKEE Wards 6-12	town
Village of Windsor Wards 1-2	town
Village of Windsor Wards 3-5	town
Village of Windsor Wards 6-10	town
CITY OF EDGERTON Ward 7	town
City of FITCHBURG Wards 1-4	town
City of FITCHBURG Wards 5-9	town
City of FITCHBURG Wards 10-13	town
City of FITCHBURG Ward 14	town
City of FITCHBURG Wards 15,18-19	town
City of FITCHBURG Wards 16-17	town
City of FITCHBURG Ward 20	town
City of MADISON Ward 1	town
City of MADISON Ward 2	town
City of MADISON Ward 3	town
City of MADISON Ward 4	town
City of MADISON Ward 5	town
City of MADISON Ward 6	town
City of MADISON Ward 7	town
City of MADISON Ward 8	town
City of MADISON Ward 9	town
City of MADISON Ward 10	town
City of MADISON Ward 11	town
City of MADISON Ward 12	town
City of MADISON Ward 13	town
City of MADISON Ward 14	town
City of MADISON Ward 15	town
City of MADISON Ward 16	town
City of MADISON Ward 17	town
City of MADISON Ward 18	town
City of MADISON Ward 19	town
City of MADISON Ward 20	town
City of MADISON Ward 21	town
City of MADISON Ward 22	town
City of MADISON Ward 23	town
City of MADISON Ward 24	town
City of MADISON Ward 25	town
City of MADISON Ward 26	town
City of MADISON Ward 27	town
City of MADISON Ward 28	town
City of MADISON Ward 29	town
City of MADISON Ward 30	town
City of MADISON Ward 31	town
City of MADISON Ward 32	town
City of MADISON Ward 33	town
City of MADISON Ward 34	town
City of MADISON Ward 35	town
City of MADISON Ward 36	town
City of MADISON Ward 37	town
City of MADISON Ward 38	town
City of MADISON Ward 39	town
City of MADISON Ward 40	town
City of MADISON Ward 41	town
City of MADISON Ward 42	town
City of MADISON Ward 43	town
City of MADISON Ward 44	town
City of MADISON Ward 45	town
City of MADISON Ward 46	town
City of MADISON Ward 47	town
City of MADISON Ward 48	town
City of MADISON Ward 49	town
City of MADISON Ward 50	town
City of MADISON Ward 51	town
City of MADISON Ward 52	town
City of MADISON Ward 53	town
City of MADISON Ward 54	town
City of MADISON Ward 55	town
City of MADISON Ward 56	town
City of MADISON Ward 57	town
City of MADISON Ward 58	town
City of MADISON Ward 59	town
City of MADISON Ward 60	town
City of MADISON Ward 61	town
City of MADISON Ward 62	town
City of MADISON Ward 63	town
City of MADISON Ward 64	town
City of MADISON Ward 65	town
City of MADISON Ward 66	town
City of MADISON Ward 67	town
City of MADISON Ward 68	town
City of MADISON Ward 69	town
City of MADISON Ward 70	town
City of MADISON Ward 71	town
City of MADISON Ward 72	town
City of MADISON Ward 73	town
City of MADISON Ward 74	town
City of MADISON Ward 75	town
City of MADISON Ward 76	town
City of MADISON Ward 77	town
City of MADISON Ward 78	town
City of MADISON Ward 79	town
City of MADISON Ward 80	town
City of MADISON Ward 81	town
City of MADISON Ward 82	town
City of MADISON Ward 83	town
City of MADISON Ward 84	town
City of MADISON Ward 85	town
City of MADISON Ward 86	town
City of MADISON Ward 87	town
City of MADISON Ward 88	town
City of MADISON Ward 89	town
City of MADISON Ward 90	town
City of MADISON Ward 91	town
City of MADISON Ward 92	town
City of MADISON Ward 93	town
City of MADISON Ward 94	town
City of MADISON Ward 95	town
City of MADISON Ward 96	town
City of MADISON Ward 97	town
City of MADISON Ward 98	town
City of MADISON Ward 99	town
City of MADISON Ward 100	town
City of MADISON Ward 101	town
City of MADISON Ward 102	town
City of MADISON Ward 103	town
City of MADISON Ward 104	town
City of MADISON Ward 105	town
City of MADISON Ward 106	town
City of MADISON Ward 107	town
City of MADISON Ward 108	town
City of MADISON Ward 109	town
City of MADISON Ward 110	town
City of MADISON Ward 111	town
City of MADISON Ward 112	town
City of MADISON Ward 113	town
City of MADISON Ward 114	town
City of MADISON Ward 115	town
City of MADISON Ward 116	town
City of MADISON Ward 117	town
City of MADISON Ward 118	town
City of MADISON Ward 119	town
City of MADISON Ward 120	town
City of MADISON Ward 121	town
City of MADISON Ward 122	town
City of MADISON Ward 123	town
City of MADISON Ward 124	town
City of MADISON Ward 125	town
City of MADISON Ward 126	town
City of MADISON Ward 127	town
City of MADISON Ward 128	town
City of MADISON Ward 129	town
City of MADISON Ward 130	town
City of MADISON Ward 131	town
City of MADISON Ward 132	town
City of MADISON Ward 133	town
City of MADISON Ward 134	town
City of MADISON Ward 135	town
City of MADISON Ward 136	town
City of MADISON Ward 137	town
City of MADISON Ward 138	town
City of MADISON Ward 139	town
City of MADISON Ward 140	town
City of MADISON Ward 141	town
City of MADISON Ward 142	town
City of MADISON Ward 143	town
City of MADISON Ward 144	town
City of MADISON Ward 145	town
City of MADISON Ward 146	town
City of MADISON Ward 147	town
City of MADISON Ward 148	town
City of MADISON Ward 149	town
City of MADISON Ward 150	town
City of MADISON Ward 151	town
City of MADISON Ward 152	town
City of MADISON Ward 154	town
City of MIDDLETON Wards 1-4,9,20	town
City of MIDDLETON Wards 5-8	town
City of MIDDLETON Wards 10-13,22	town
City of MIDDLETON Wards 14-16,18,17,21	town
City of MIDDLETON Ward 19	town
City of MONONA Wards 1-5	town
City of MONONA Wards 6-10	town
City of STOUGHTON Wards 1-2	town
City of STOUGHTON Wards 3-4,12	town
City of STOUGHTON Wards 5-6	town
City of STOUGHTON Wards 7-8,15	town
City of STOUGHTON Ward 9	town
City of STOUGHTON Wards 10-11,13-14	town
City of STOUGHTON Ward 16	town
City of SUN PRAIRIE Wards 1-19,26	town
City of SUN PRAIRIE Wards 20-22,24-25,28	town
City of SUN PRAIRIE Wards 23,27	town
City of VERONA Wards 1,5	town
City of VERONA Wards 2-4	town
City of VERONA Wards 6-9	town
Town of ASHIPPUN Wards 1-4	town
Town of BEAVER DAM Wards 1-4,7-11	town
Town of BEAVER DAM Wards 5-6	town
Town of BURNETT Wards 1-2	town
Town of CALAMUS Wards 1-2	town
Town of CHESTER Wards 1-2	town
Town of CLYMAN Ward 1	town
Town of ELBA Ward 1	town
Town of EMMET Wards 1-2	town
Town of FOX LAKE Wards 1-4	town
Town of HERMAN Wards 1-2	town
Town of HUBBARD Wards 1-4	town
Town of HUBBARD Wards 5-6	town
Town of HUSTISFORD Wards 1-2	town
Town of LEBANON Wards 1-2	town
Town of LEROY Wards 1-2	town
Town of LOMIRA Wards 1-2	town
Town of LOMIRA Ward 3	town
Town of LOWELL Wards 1-2	town
Town of LOWELL Wards 3-4	town
Town of OAK GROVE Wards 3-5	town
Town of PORTLAND Wards 1-2	town
Town of RUBICON Wards 1-3	town
Town of SHIELDS Ward 1	town
Town of THERESA Wards 1,3-7	town
Town of THERESA Ward 2	town
Town of TRENTON Wards 1-2	town
Town of WESTFORD Wards 1-2	town
Town of WESTFORD Ward 3	town
Village of BROWNSVILLE Ward 1	town
Village of CLYMAN Ward 1	town
Village of HUSTISFORD Wards 1-2	town
Village of IRON RIDGE Ward 1	town
Village of KEKOSKEE Wards 1-3	town
Village of LOMIRA Wards 1-3	town
Village of LOWELL Ward 1	town
Village of NEOSHO Ward 1	town
Village of RANDOLPH Wards 1-2	town
Village of REESEVILLE Ward 1	town
Village of THERESA Wards 1-3	town
City of BEAVER DAM Wards 1,3,5	town
City of BEAVER DAM Wards 2,6	town
City of BEAVER DAM Wards 4,8,10,14	town
City of BEAVER DAM Wards 7,12-13	town
City of BEAVER DAM Wards 9,11	town
City of BEAVER DAM Ward 15	town
City of BEAVER DAM Ward 16	town
CITY OF COLUMBUS Ward 9	town
City of FOX LAKE Wards 1-3	town
CITY OF HARTFORD Wards 18-19	town
City of HORICON Wards 1-6	town
City of HORICON Ward 7	town
City of JUNEAU Wards 1-3	town
City of MAYVILLE Wards 1-8	town
CITY OF WATERTOWN Wards 1-2	town
CITY OF WATERTOWN Wards 3-4	town
CITY OF WATERTOWN Wards 5-6	town
CITY OF WATERTOWN Ward 7	town
City of WAUPUN Wards 1-8	town
City of WAUPUN Wards 13-14	town
Town of BAILEYS HARBOR Wards 1-2	town
Town of BRUSSELS Wards 1-2	town
Town of CLAY BANKS Ward 1	town
Town of EGG HARBOR Wards 1-3	town
Town of FORESTVILLE Wards 1-2	town
Town of GARDNER Wards 1-2	town
Town of GIBRALTAR Wards 1-2	town
Town of JACKSONPORT Wards 1-2	town
Town of LIBERTY GROVE Wards 1-3	town
Town of NASEWAUPEE Wards 1-3	town
Town of SEVASTOPOL Wards 1-5	town
Town of STURGEON BAY Wards 1-2	town
Town of WASHINGTON Ward 1	town
Village of EGG HARBOR Ward 1	town
Village of EPHRAIM Ward 1	town
Village of FORESTVILLE Ward 1	town
Village of SISTER BAY Ward 1	town
City of STURGEON BAY Wards 1-6,22-24,29	town
City of STURGEON BAY Wards 7-10,18-21,25-27,30	town
City of STURGEON BAY Wards 11-17,28	town
Town of AMNICON Wards 1-2	town
Town of BENNETT Ward 1	town
Town of BRULE Wards 1-2	town
Town of CLOVERLAND Ward 1	town
Town of DAIRYLAND Ward 1	town
Town of GORDON Ward 1	town
Town of HAWTHORNE Wards 1-2	town
Town of HIGHLAND Ward 1	town
Town of LAKESIDE Ward 1	town
Town of MAPLE Ward 1	town
Town of PARKLAND Wards 1-2	town
Town of SOLON SPRINGS Wards 1-3	town
Town of SUMMIT Wards 1-2	town
Town of SUPERIOR Wards 1-2	town
Town of WASCOTT Ward 1	town
Village of LAKE NEBAGAMON Wards 1-2	town
Village of OLIVER Ward 1	town
Village of POPLAR Ward 1	town
Village of SOLON SPRINGS Ward 1	town
Village of SUPERIOR Ward 1	town
City of SUPERIOR Wards 1-3,7-8	town
City of SUPERIOR Wards 4-6,9-12	town
City of SUPERIOR Wards 13-16,20-22	town
City of SUPERIOR Wards 17-19,30-32	town
City of SUPERIOR Wards 23-29	town
Town of COLFAX Wards 1-3	town
Town of DUNN Wards 1-2	town
Town of EAU GALLE Ward 1	town
Town of ELK MOUND Wards 1-3	town
Town of HAY RIVER Wards 1-2	town
Town of LUCAS Ward 1	town
Town of MENOMONIE Wards 1-3	town
Town of OTTER CREEK Ward 1	town
Town of PERU Ward 1	town
Town of RED CEDAR Wards 1-3	town
Town of ROCK CREEK Ward 1	town
Town of SAND CREEK Ward 1	town
Town of SHERIDAN Ward 1	town
Town of SHERMAN Ward 1	town
Town of SPRING BROOK Wards 1-2	town
Town of STANTON Ward 1	town
Town of TAINTER Wards 1-3	town
Town of TIFFANY Wards 1-2	town
Town of WILSON Ward 1	town
Village of BOYCEVILLE Ward 1	town
Village of COLFAX Wards 1-2	town
Village of DOWNING Ward 1	town
Village of ELK MOUND Ward 1	town
Village of KNAPP Ward 1	town
Village of RIDGELAND Ward 1	town
Village of WHEELER Ward 1	town
City of MENOMONIE Wards 1-2	town
City of MENOMONIE Wards 3-4	town
City of MENOMONIE Wards 5,7	town
City of MENOMONIE Ward 6	town
City of MENOMONIE Wards 8-9	town
City of MENOMONIE Wards 10-11	town
City of MENOMONIE Ward 12	town
Town of BRIDGE CREEK Wards 1-2	town
Town of BRUNSWICK Wards 1-2	town
Town of CLEAR CREEK Wards 1-2	town
Town of DRAMMEN Ward 1	town
Town of FAIRCHILD Ward 1	town
Town of LINCOLN Wards 1-2	town
Town of LUDINGTON Ward 1	town
Town of PLEASANT VALLEY Wards 1-4	town
Town of SEYMOUR Wards 1-6	town
Town of UNION Wards 1-4	town
Town of WASHINGTON Wards 1-13	town
Village of FAIRCHILD Ward 1	town
Village of FALL CREEK Wards 1-2	town
City of ALTOONA Wards 1-11	town
City of ALTOONA Wards 12-16	town
City of AUGUSTA Wards 1-5	town
City of EAU CLAIRE Ward 1	town
City of EAU CLAIRE Ward 2	town
City of EAU CLAIRE Ward 3	town
City of EAU CLAIRE Ward 4	town
City of EAU CLAIRE Ward 5	town
City of EAU CLAIRE Ward 6	town
City of EAU CLAIRE Ward 7	town
City of EAU CLAIRE Ward 8	town
City of EAU CLAIRE Ward 9	town
City of EAU CLAIRE Ward 10	town
City of EAU CLAIRE Ward 11	town
City of EAU CLAIRE Ward 12	town
City of EAU CLAIRE Ward 13	town
City of EAU CLAIRE Ward 14	town
City of EAU CLAIRE Ward 15	town
City of EAU CLAIRE Ward 17	town
City of EAU CLAIRE Ward 18	town
City of EAU CLAIRE Ward 19	town
City of EAU CLAIRE Ward 20	town
City of EAU CLAIRE Ward 21	town
City of EAU CLAIRE Ward 22	town
City of EAU CLAIRE Ward 23	town
City of EAU CLAIRE Ward 24	town
City of EAU CLAIRE Ward 25	town
City of EAU CLAIRE Ward 26	town
City of EAU CLAIRE Ward 27	town
City of EAU CLAIRE Ward 28	town
City of EAU CLAIRE Ward 29	town
City of EAU CLAIRE Ward 30	town
City of EAU CLAIRE Ward 31	town
City of EAU CLAIRE Ward 32	town
City of EAU CLAIRE Ward 33	town
City of EAU CLAIRE Ward 34	town
City of EAU CLAIRE Ward 35	town
City of EAU CLAIRE Ward 36	town
City of EAU CLAIRE Ward 37	town
City of EAU CLAIRE Ward 38	town
City of EAU CLAIRE Ward 39	town
City of EAU CLAIRE Ward 42	town
City of EAU CLAIRE Ward 43	town
City of EAU CLAIRE Ward 44	town
City of EAU CLAIRE Ward 45	town
City of EAU CLAIRE Ward 46	town
City of EAU CLAIRE Ward 47	town
City of EAU CLAIRE Ward 48	town
City of EAU CLAIRE Ward 49	town
City of EAU CLAIRE Ward 50	town
City of EAU CLAIRE Ward 51	town
City of EAU CLAIRE Ward 52	town
City of EAU CLAIRE Ward 53	town
City of EAU CLAIRE Ward 54	town
City of EAU CLAIRE Ward 55	town
City of EAU CLAIRE Ward 56	town
City of EAU CLAIRE Ward 57	town
City of EAU CLAIRE Ward 58	town
City of EAU CLAIRE Ward 59	town
City of EAU CLAIRE Ward 60	town
City of EAU CLAIRE Ward 61	town
City of EAU CLAIRE Ward 62	town
City of EAU CLAIRE Ward 63	town
City of EAU CLAIRE Ward 64	town
City of EAU CLAIRE Ward 65	town
City of EAU CLAIRE Ward 66	town
City of EAU CLAIRE Ward 67	town
City of EAU CLAIRE Ward 68	town
City of EAU CLAIRE Ward 69	town
City of EAU CLAIRE Ward 70	town
City of EAU CLAIRE Ward 71	town
City of EAU CLAIRE Ward 72	town
City of EAU CLAIRE Ward 73	town
City of EAU CLAIRE Ward 74	town
City of EAU CLAIRE Ward 75	town
City of EAU CLAIRE Ward 76	town
City of EAU CLAIRE Ward 77	town
City of EAU CLAIRE Ward 79	town
City of EAU CLAIRE Ward 80	town
City of EAU CLAIRE Ward 81	town
Town of AURORA Wards 1-3	town
Town of COMMONWEALTH Wards 1-3	town
Town of FENCE Ward 1	town
Town of FERN Ward 1	town
Town of FLORENCE Wards 1-7	town
Town of HOMESTEAD Ward 1	town
Town of LONG LAKE Ward 1	town
Town of TIPLER Ward 1	town
Town of ALTO Wards 1-2	town
Town of ASHFORD Wards 1-3	town
Town of AUBURN Wards 1-3	town
Town of BYRON Wards 1-2	town
Town of CALUMET Ward 1	town
Town of CALUMET Ward 2	town
Town of EDEN Wards 1-2	town
Town of ELDORADO Wards 1-3	town
Town of EMPIRE Wards 1-4	town
Town of FOND DU LAC Ward 1A	town
Town of FOND DU LAC Wards 1,2-8	town
Town of FOREST Wards 1-2	town
Town of FRIENDSHIP Wards 1-3	town
Town of LAMARTINE Wards 1-2	town
Town of MARSHFIELD Wards 1-2	town
Town of METOMEN Wards 1-2	town
Town of OAKFIELD Wards 1-2	town
Town of OSCEOLA Wards 1-2	town
Town of RIPON Wards 1-2	town
Town of ROSENDALE Ward 1	town
Town of SPRINGVALE Ward 1	town
Town of TAYCHEEDAH Wards 1-5	town
Town of WAUPUN Wards 1-2	town
Village of BRANDON Ward 1	town
Village of CAMPBELLSPORT Wards 1-4	town
Village of EDEN Ward 1	town
Village of FAIRWATER Ward 1	town
VILLAGE OF KEWASKUM Ward 6	town
Village of MOUNT CALVARY Ward 1	town
Village of NORTH FOND DU LAC Wards 1-7	town
Village of OAKFIELD Wards 1-2	town
Village of ROSENDALE Wards 1-2	town
Village of ST. CLOUD Ward 1	town
City of FOND DU LAC Ward 1	town
City of FOND DU LAC Ward 2	town
City of FOND DU LAC Ward 3	town
City of FOND DU LAC Ward 4	town
City of FOND DU LAC Ward 5	town
City of FOND DU LAC Ward 6	town
City of FOND DU LAC Ward 7	town
City of FOND DU LAC Ward 8	town
City of FOND DU LAC Ward 9	town
City of FOND DU LAC Ward 10	town
City of FOND DU LAC Ward 11	town
City of FOND DU LAC Ward 12	town
City of FOND DU LAC Ward 13	town
City of FOND DU LAC Ward 14	town
City of FOND DU LAC Ward 15	town
City of FOND DU LAC Ward 16	town
City of FOND DU LAC Ward 17	town
City of FOND DU LAC Ward 18	town
City of FOND DU LAC Ward 19	town
City of FOND DU LAC Ward 20	town
City of FOND DU LAC Ward 21	town
City of FOND DU LAC Ward 22	town
City of FOND DU LAC Ward 23	town
City of FOND DU LAC Ward 24	town
City of FOND DU LAC Ward 25	town
City of FOND DU LAC Ward 26	town
City of FOND DU LAC Ward 27	town
City of FOND DU LAC Ward 28	town
City of FOND DU LAC Ward 29	town
City of FOND DU LAC Ward 30	town
City of FOND DU LAC Ward 31	town
City of RIPON Wards 1-3	town
City of RIPON Wards 4-6	town
City of RIPON Wards 7-8	town
City of RIPON Wards 9-11	town
CITY OF WAUPUN Ward 9B	town
CITY OF WAUPUN Wards 9-9A,10-12	town
Town of ALVIN Ward 1	town
Town of ARGONNE Wards 1-3	town
Town of ARMSTRONG CREEK Ward 1	town
Town of BLACKWELL Ward 1	town
Town of CASWELL Ward 1	town
Town of CRANDON Wards 1-3	town
Town of FREEDOM Ward 1	town
Town of HILES Ward 1	town
Town of LAONA Wards 1-3	town
Town of LINCOLN Wards 1-3	town
Town of NASHVILLE Ward 1	town
Town of NASHVILLE Ward 2	town
Town of NASHVILLE Ward 3	town
Town of POPPLE RIVER Ward 1	town
Town of ROSS Ward 1	town
Town of WABENO Wards 1-5	town
City of CRANDON Wards 1-4	town
Town of BEETOWN Ward 1	town
Town of BLOOMINGTON Ward 1	town
Town of BOSCOBEL Wards 1-2	town
Town of CASSVILLE Ward 1	town
Town of CASTLE ROCK Ward 1	town
Town of CLIFTON Wards 1-2	town
Town of ELLENBORO Ward 1	town
Town of FENNIMORE Wards 1-2	town
Town of GLEN HAVEN Ward 1	town
Town of HARRISON Ward 1	town
Town of HAZEL GREEN Wards 1-2	town
Town of HICKORY GROVE Ward 1	town
Town of JAMESTOWN Wards 1-3	town
Town of LIBERTY Ward 1	town
Town of LIMA Ward 1	town
Town of LITTLE GRANT Ward 1	town
Town of MARION Ward 1	town
Town of MILLVILLE Ward 1	town
Town of MOUNT HOPE Ward 1	town
Town of MOUNT IDA Ward 1	town
Town of MUSCODA Ward 1	town
Town of NORTH LANCASTER Wards 1-2	town
Town of PARIS Wards 1-2	town
Town of PATCH GROVE Ward 1	town
Town of PLATTEVILLE Wards 1-3	town
Town of POTOSI Ward 1	town
Town of SMELSER Wards 1-2	town
Town of SOUTH LANCASTER Wards 1-3	town
Town of WATERLOO Ward 1	town
Town of WATTERSTOWN Wards 1-2	town
Town of WINGVILLE Ward 1	town
Town of WOODMAN Ward 1	town
Town of WYALUSING Ward 1	town
Village of BAGLEY Ward 1	town
Village of BLOOMINGTON Ward 1	town
Village of BLUE RIVER Ward 1	town
Village of CASSVILLE Wards 1-2	town
Village of DICKEYVILLE Wards 1-2	town
Village of HAZEL GREEN Wards 1-2	town
Village of LIVINGSTON Ward 1	town
Village of MONTFORT Ward 1	town
Village of MOUNT HOPE Ward 1	town
Village of MUSCODA Wards 1-2	town
Village of PATCH GROVE Ward 1	town
Village of POTOSI Ward 1	town
Village of TENNYSON Ward 1	town
Village of WOODMAN Ward 1	town
City of BOSCOBEL Wards 1-4	town
City of CUBA CITY Wards 1-4	town
City of FENNIMORE Wards 1-4	town
City of LANCASTER Wards 1-6	town
City of PLATTEVILLE Wards 1-2	town
City of PLATTEVILLE Wards 3-4	town
City of PLATTEVILLE Wards 5-6	town
City of PLATTEVILLE Wards 7-9	town
Town of ADAMS Ward 1	town
Town of ALBANY Wards 1-2	town
Town of BROOKLYN Wards 1-3	town
Town of CADIZ Ward 1	town
Town of CLARNO Wards 1-2	town
Town of DECATUR Wards 1-3	town
Town of EXETER Wards 1-4	town
Town of JEFFERSON Wards 1-2	town
Town of JORDAN Ward 1	town
Town of MONROE Wards 1-2	town
Town of MOUNT PLEASANT Ward 1	town
Town of MOUNT PLEASANT Wards 2-3	town
Town of NEW GLARUS Wards 1-2	town
Town of SPRING GROVE Ward 1	town
Town of SYLVESTER Wards 1-2	town
Village of ALBANY Wards 1-2	town
VILLAGE OF BELLEVILLE Ward 3	town
VILLAGE OF BROOKLYN Ward 2	town
Village of BROWNTOWN Ward 1	town
Village of MONTICELLO Wards 1-2	town
Village of NEW GLARUS Wards 1-4	town
City of BRODHEAD Wards 1-6	town
City of MONROE Wards 1-9	town
City of MONROE Ward 10	town
Town of BERLIN Wards 1-3	town
Town of GREEN LAKE Wards 1-2	town
Town of KINGSTON Wards 1-2	town
Town of MACKFORD Ward 1	town
Town of MANCHESTER Ward 1	town
Town of MARQUETTE Ward 1	town
Town of PRINCETON Wards 1-4	town
Town of ST. MARIE Wards 1-2	town
Village of KINGSTON Ward 1	town
Village of MARQUETTE Ward 1	town
City of BERLIN Wards 1-6	town
City of GREEN LAKE Wards 1-5	town
City of MARKESAN Wards 1-3	town
City of PRINCETON Wards 1-4	town
Town of ARENA Wards 1-2	town
Town of BRIGHAM Wards 1-2	town
Town of CLYDE Ward 1	town
Town of DODGEVILLE Wards 1-4	town
Town of EDEN Ward 1	town
Town of HIGHLAND Wards 1-2	town
Town of LINDEN Wards 1-3	town
Town of MIFFLIN Wards 1-2	town
Town of MINERAL POINT Wards 1-2	town
Town of MOSCOW Wards 1-2	town
Town of PULASKI Ward 1	town
Town of RIDGEWAY Wards 1-2	town
Town of WALDWICK Wards 1-2	town
Town of WYOMING Wards 1-2	town
Village of ARENA Ward 1	town
Village of AVOCA Ward 1	town
Village of BARNEVELD Wards 1-2	town
VILLAGE OF BLANCHARDVILLE Ward 2	town
Village of COBB Ward 1	town
Village of HIGHLAND Ward 1	town
Village of HOLLANDALE Ward 1	town
Village of LINDEN Ward 1	town
VILLAGE OF LIVINGSTON Ward 2	town
VILLAGE OF MONTFORT Ward 2	town
VILLAGE OF MUSCODA Ward 3	town
Village of REWEY Ward 1	town
Village of RIDGEWAY Ward 1	town
City of DODGEVILLE Wards 1-10	town
City of MINERAL POINT Wards 1-6	town
Town of CAREY Ward 1	town
Town of GURNEY Ward 1	town
Town of KIMBALL Ward 1	town
Town of KNIGHT Ward 1	town
Town of MERCER Wards 1-4	town
Town of OMA Ward 1	town
Town of PENCE Ward 1	town
Town of SAXON Ward 1	town
City of HURLEY Ward 1	town
City of HURLEY Ward 2	town
City of HURLEY Ward 3	town
City of HURLEY Ward 4	town
City of MONTREAL Wards 1-2	town
Town of ALBION Wards 1-4	town
Town of ALMA Wards 1,4	town
Town of ALMA Wards 2-3,5	town
Town of BEAR BLUFF Ward 1	town
Town of BROCKWAY Wards 1-6	town
Town of CITY POINT Ward 1	town
Town of CURRAN Ward 1	town
Town of FRANKLIN Ward 1	town
Town of GARDEN VALLEY Ward 1	town
Town of GARFIELD Ward 1	town
Town of HIXTON Wards 1-2	town
Town of IRVING Wards 1-3	town
Town of KNAPP Ward 1	town
Town of KOMENSKY Ward 1	town
Town of MELROSE Ward 1	town
Town of MILLSTON Ward 1	town
Town of NORTH BEND Ward 1	town
Town of NORTHFIELD Ward 1	town
Town of SPRINGFIELD Ward 1	town
Village of ALMA CENTER Ward 1	town
Village of HIXTON Ward 1	town
Village of MELROSE Ward 1	town
Village of MERRILLAN Ward 1	town
Village of TAYLOR Ward 1	town
City of BLACK RIVER FALLS Ward 1	town
City of BLACK RIVER FALLS Ward 2	town
City of BLACK RIVER FALLS Ward 3	town
City of BLACK RIVER FALLS Ward 4	town
Town of AZTALAN Wards 1-2	town
Town of COLD SPRING Ward 1	town
Town of CONCORD Wards 1-3	town
Town of FARMINGTON Wards 1-2	town
Town of HEBRON Wards 1-2	town
Town of IXONIA Wards 1-6	town
Town of JEFFERSON Wards 1-3	town
Town of KOSHKONONG Wards 1,6	town
Town of KOSHKONONG Wards 2-5	town
Town of LAKE MILLS Wards 1-3	town
Town of MILFORD Wards 1-2	town
Town of OAKLAND Wards 1-4	town
Town of PALMYRA Wards 1-2	town
Town of SULLIVAN Wards 1-3	town
Town of WATERTOWN Wards 1-2	town
VILLAGE OF CAMBRIDGE Ward 1	town
Village of JOHNSON CREEK Wards 1-3	town
VILLAGE OF LAC LA BELLE Ward 2	town
Village of PALMYRA Wards 1-2	town
Village of SULLIVAN Ward 1	town
City of FORT ATKINSON Wards 1-9	town
City of JEFFERSON Wards 1-10	town
City of JEFFERSON Ward 11	town
City of LAKE MILLS Wards 1-8	town
City of WATERLOO Wards 1-5	town
City of WATERTOWN Ward 8	town
City of WATERTOWN Wards 9-10	town
City of WATERTOWN Wards 11-12	town
City of WATERTOWN Wards 13-14	town
City of WATERTOWN Wards 15-16	town
City of WATERTOWN Wards 17-18	town
City of WATERTOWN Ward 19	town
CITY OF WHITEWATER Wards 10-11	town
CITY OF WHITEWATER Ward 12	town
Town of ARMENIA Ward 1	town
Town of CLEARFIELD Ward 1	town
Town of CLEARFIELD Ward 2	town
Town of CUTLER Ward 1	town
Town of FINLEY Ward 1	town
Town of FOUNTAIN Wards 1-2	town
Town of GERMANTOWN Wards 1,3	town
Town of GERMANTOWN Ward 2	town
Town of KILDARE Ward 1	town
Town of KINGSTON Ward 1	town
Town of LEMONWEIR Wards 1-4	town
Town of LINDINA Ward 1	town
Town of LISBON Wards 1-2	town
Town of LISBON Ward 3	town
Town of LYNDON Wards 1-3	town
Town of NECEDAH Wards 1-4	town
Town of ORANGE Ward 1	town
Town of PLYMOUTH Ward 1	town
Town of SEVEN MILE CREEK Wards 1-2	town
Town of SUMMIT Ward 1	town
Town of WONEWOC Wards 1-2	town
Village of CAMP DOUGLAS Ward 1	town
Village of HUSTLER Ward 1	town
Village of LYNDON STATION Ward 1	town
Village of NECEDAH Ward 1	town
Village of UNION CENTER Ward 1	town
Village of WONEWOC Ward 1	town
City of ELROY Wards 1-7	town
City of MAUSTON Wards 1-7	town
City of NEW LISBON Wards 1-7	town
CITY OF WISCONSIN DELLS Ward 7	town
Town of BRIGHTON Wards 1-4	town
Town of RANDALL Wards 1-7	town
Town of SOMERS Ward 1	town
Town of SOMERS Ward 2	town
Town of WHEATLAND Wards 1-6	town
Village of BRISTOL Wards 1-3,8	town
Village of BRISTOL Wards 4-7	town
VILLAGE OF GENOA CITY Ward 5	town
Village of PADDOCK LAKE Wards 1-6	town
Village of PLEASANT PRAIRIE Wards 1-3	town
Village of PLEASANT PRAIRIE Wards 4-5	town
Village of PLEASANT PRAIRIE Wards 6-7,12	town
Village of PLEASANT PRAIRIE Wards 8-11	town
Village of PLEASANT PRAIRIE Wards 13-14	town
Village of SALEM LAKES Wards 1-5,10	town
Village of SALEM LAKES Wards 6-9	town
Village of SALEM LAKES Wards 11-13	town
Village of SOMERS Wards 1-4	town
Village of SOMERS Wards 5-6,9-10	town
Village of SOMERS Wards 7-8	town
Village of SOMERS Ward 11	town
Village of SOMERS Ward 12	town
Village of TWIN LAKES Wards 1-9	town
City of KENOSHA Ward 1	town
City of KENOSHA Ward 2	town
City of KENOSHA Ward 3	town
City of KENOSHA Ward 4	town
City of KENOSHA Ward 5	town
City of KENOSHA Ward 6	town
City of KENOSHA Ward 7	town
City of KENOSHA Ward 8	town
City of KENOSHA Ward 9	town
City of KENOSHA Ward 10	town
City of KENOSHA Ward 11	town
City of KENOSHA Ward 12	town
City of KENOSHA Ward 13	town
City of KENOSHA Ward 14	town
City of KENOSHA Ward 15	town
City of KENOSHA Ward 16	town
City of KENOSHA Ward 17	town
City of KENOSHA Ward 18	town
City of KENOSHA Ward 19	town
City of KENOSHA Ward 20	town
City of KENOSHA Ward 21	town
City of KENOSHA Ward 22	town
City of KENOSHA Ward 23	town
City of KENOSHA Ward 24	town
City of KENOSHA Ward 25	town
City of KENOSHA Ward 26	town
City of KENOSHA Ward 27	town
City of KENOSHA Ward 28	town
City of KENOSHA Ward 29	town
City of KENOSHA Ward 30	town
City of KENOSHA Ward 31	town
City of KENOSHA Ward 32	town
City of KENOSHA Ward 33	town
City of KENOSHA Ward 34	town
City of KENOSHA Ward 35	town
City of KENOSHA Ward 36	town
City of KENOSHA Ward 37	town
City of KENOSHA Ward 38	town
City of KENOSHA Ward 39	town
City of KENOSHA Ward 40	town
City of KENOSHA Ward 41	town
City of KENOSHA Ward 42	town
City of KENOSHA Ward 43	town
City of KENOSHA Ward 44	town
City of KENOSHA Ward 45	town
City of KENOSHA Ward 46	town
City of KENOSHA Ward 47	town
City of KENOSHA Ward 48	town
City of KENOSHA Ward 49	town
City of KENOSHA Ward 50	town
City of KENOSHA Ward 51	town
City of KENOSHA Ward 52	town
City of KENOSHA Ward 53	town
City of KENOSHA Ward 54	town
City of KENOSHA Ward 55	town
City of KENOSHA Ward 56	town
City of KENOSHA Ward 57	town
City of KENOSHA Ward 58	town
City of KENOSHA Ward 59	town
City of KENOSHA Ward 60	town
City of KENOSHA Ward 61	town
City of KENOSHA Ward 62	town
City of KENOSHA Ward 63	town
City of KENOSHA Ward 64	town
City of KENOSHA Ward 65	town
City of KENOSHA Ward 66	town
City of KENOSHA Ward 67	town
City of KENOSHA Ward 68	town
City of KENOSHA Ward 69	town
City of KENOSHA Ward 70	town
City of KENOSHA Ward 71	town
City of KENOSHA Ward 72	town
City of KENOSHA Ward 73	town
City of KENOSHA Ward 74	town
City of KENOSHA Ward 75	town
City of KENOSHA Ward 76	town
City of KENOSHA Ward 77	town
City of KENOSHA Ward 78	town
City of KENOSHA Ward 79	town
City of KENOSHA Ward 80	town
City of KENOSHA Ward 81	town
City of KENOSHA Ward 82	town
City of KENOSHA Ward 83	town
City of KENOSHA Ward 84	town
City of KENOSHA Ward 85	town
City of KENOSHA Ward 86	town
City of KENOSHA Ward 87	town
City of KENOSHA Ward 88	town
City of KENOSHA Ward 89	town
City of KENOSHA Ward 90	town
City of KENOSHA Ward 91	town
City of KENOSHA Ward 92	town
City of KENOSHA Ward 93	town
City of KENOSHA Ward 94	town
City of KENOSHA Ward 95	town
City of KENOSHA Ward 96	town
City of KENOSHA Ward 97	town
City of KENOSHA Ward 98	town
City of KENOSHA Ward 99	town
City of KENOSHA Ward 100	town
City of KENOSHA Ward 101	town
City of KENOSHA Ward 102	town
City of KENOSHA Ward 103	town
City of KENOSHA Ward 104	town
City of KENOSHA Ward 105	town
City of KENOSHA Ward 106	town
City of KENOSHA Ward 107	town
City of KENOSHA Ward 108	town
City of KENOSHA Ward 109	town
City of KENOSHA Ward 110	town
City of KENOSHA Ward 111	town
City of KENOSHA Ward 112	town
City of KENOSHA Ward 113	town
City of KENOSHA Ward 114	town
City of KENOSHA Ward 115	town
City of KENOSHA Ward 116	town
Town of AHNAPEE Ward 1	town
Town of CARLTON Wards 1-2	town
Town of CASCO Wards 1-3	town
Town of LUXEMBURG Wards 1-3	town
Town of MONTPELIER Wards 1-3	town
Town of PIERCE Wards 1-2	town
Town of RED RIVER Wards 1-3	town
Town of WEST KEWAUNEE Wards 1-2	town
Village of CASCO Ward 1	town
Village of LUXEMBURG Wards 1-5	town
City of ALGOMA Wards 1-6	town
City of KEWAUNEE Wards 1-5	town
Town of BANGOR Ward 1	town
Town of BARRE Wards 1-2	town
Town of BURNS Ward 1	town
Town of CAMPBELL Wards 1-6	town
Town of GREENFIELD Wards 1-2	town
Town of HAMILTON Wards 1-5	town
Town of HOLLAND Wards 1-6	town
Town of MEDARY Wards 1-2	town
Town of ONALASKA Wards 1-8	town
Town of SHELBY Wards 1-4	town
Town of SHELBY Wards 5-6	town
Village of BANGOR Wards 1-2	town
Village of HOLMEN Wards 1-14	town
Village of ROCKLAND Ward 1	town
Village of WEST SALEM Wards 1-8	town
City of LA CROSSE Ward 1	town
City of LA CROSSE Ward 2	town
City of LA CROSSE Ward 3	town
City of LA CROSSE Ward 4	town
City of LA CROSSE Ward 5	town
City of LA CROSSE Ward 6	town
City of LA CROSSE Ward 7	town
City of LA CROSSE Ward 8	town
City of LA CROSSE Ward 9	town
City of LA CROSSE Ward 10	town
City of LA CROSSE Ward 11	town
City of LA CROSSE Ward 12	town
City of LA CROSSE Ward 13	town
City of LA CROSSE Ward 14	town
City of LA CROSSE Ward 15	town
City of LA CROSSE Ward 16	town
City of LA CROSSE Ward 17	town
City of LA CROSSE Ward 18	town
City of LA CROSSE Ward 19	town
City of LA CROSSE Ward 20	town
City of LA CROSSE Ward 21	town
City of LA CROSSE Ward 22	town
City of LA CROSSE Ward 23	town
City of LA CROSSE Ward 24	town
City of LA CROSSE Ward 25	town
City of LA CROSSE Ward 26	town
City of LA CROSSE Ward 27	town
City of LA CROSSE Ward 28	town
City of LA CROSSE Ward 29	town
City of LA CROSSE Ward 30	town
City of LA CROSSE Ward 31	town
City of LA CROSSE Ward 32	town
City of LA CROSSE Ward 33	town
City of LA CROSSE Ward 34	town
City of LA CROSSE Ward 35	town
City of ONALASKA Wards 1-4	town
City of ONALASKA Wards 5-8	town
City of ONALASKA Wards 9-12	town
Town of ARGYLE Wards 1-3	town
Town of BELMONT Wards 1-2	town
Town of BENTON Wards 1-2	town
Town of BLANCHARD Ward 1	town
Town of DARLINGTON Wards 1-3	town
Town of ELK GROVE Wards 1-2	town
Town of FAYETTE Wards 1-2	town
Town of GRATIOT Ward 1	town
Town of KENDALL Ward 1	town
Town of LAMONT Wards 1-2	town
Town of MONTICELLO Ward 1	town
Town of NEW DIGGINGS Ward 1	town
Town of SEYMOUR Wards 1-2	town
Town of SHULLSBURG Ward 1	town
Town of WAYNE Ward 1	town
Town of WHITE OAK SPRINGS Ward 1	town
Town of WILLOW SPRINGS Ward 1	town
Town of WIOTA Ward 1	town
Village of ARGYLE Ward 1	town
Village of BELMONT Ward 1	town
Village of BENTON Ward 1	town
Village of BLANCHARDVILLE Ward 1	town
Village of GRATIOT Ward 1	town
VILLAGE OF HAZEL GREEN Ward 3	town
Village of SOUTH WAYNE Ward 1	town
CITY OF CUBA CITY Ward 5	town
City of DARLINGTON Wards 1-6	town
City of SHULLSBURG Wards 1-3	town
Town of ACKLEY Ward 1	town
Town of AINSWORTH Ward 1	town
Town of ANTIGO Wards 1-2	town
Town of ELCHO Wards 1-2	town
Town of EVERGREEN Ward 1	town
Town of LANGLADE Wards 1-2	town
Town of NEVA Ward 1	town
Town of NORWOOD Ward 1	town
Town of PARRISH Ward 1	town
Town of PECK Ward 1	town
Town of POLAR Wards 1-2	town
Town of PRICE Wards 1-2	town
Town of ROLLING Wards 1-2	town
Town of UPHAM Ward 1	town
Town of VILAS Ward 1	town
Town of WOLF RIVER Wards 1-2	town
Village of WHITE LAKE Ward 1	town
City of ANTIGO Ward 1	town
City of ANTIGO Ward 2	town
City of ANTIGO Ward 3	town
City of ANTIGO Ward 4	town
City of ANTIGO Ward 5	town
City of ANTIGO Ward 6	town
City of ANTIGO Ward 7	town
City of ANTIGO Ward 8	town
City of ANTIGO Ward 9	town
Town of BIRCH Ward 1	town
Town of BRADLEY Wards 1-5	town
Town of CORNING Wards 1-2	town
Town of HARDING Ward 1	town
Town of HARRISON Wards 1-3	town
Town of KING Wards 1-2	town
Town of MERRILL Wards 1-7	town
Town of PINE RIVER Wards 1-3	town
Town of ROCK FALLS Wards 1-2	town
Town of RUSSELL Ward 1	town
Town of SCHLEY Wards 1-2	town
Town of SKANAWAN Ward 1	town
Town of SOMO Ward 1	town
Town of TOMAHAWK Ward 1	town
City of MERRILL Wards 1-2	town
City of MERRILL Wards 3-4	town
City of MERRILL Wards 5-7	town
City of MERRILL Wards 8-9	town
City of MERRILL Wards 10-12	town
City of MERRILL Wards 13-14	town
City of MERRILL Wards 15-17	town
City of MERRILL Wards 18-19	town
City of TOMAHAWK Wards 1-2	town
City of TOMAHAWK Wards 3-4	town
City of TOMAHAWK Wards 5-6	town
Town of CATO Wards 1-2	town
Town of CENTERVILLE Ward 1	town
Town of COOPERSTOWN Wards 1-2	town
Town of EATON Ward 1	town
Town of FRANKLIN Wards 1-3	town
Town of GIBSON Wards 1-2	town
Town of KOSSUTH Wards 1-3	town
Town of LIBERTY Wards 1-2	town
Town of MANITOWOC Wards 1-2	town
Town of MANITOWOC RAPIDS Wards 1-5	town
Town of MAPLE GROVE Ward 1	town
Town of MEEME Wards 1,4	town
Town of MEEME Wards 2-3	town
Town of MISHICOT Wards 1-2	town
Town of NEWTON Wards 1-3	town
Town of ROCKLAND Wards 1-2	town
Town of SCHLESWIG Wards 1-2	town
Town of TWO CREEKS Ward 1	town
Town of TWO RIVERS Wards 1-2	town
Village of CLEVELAND Wards 1-2	town
Village of FRANCIS CREEK Ward 1	town
Village of KELLNERSVILLE Ward 1	town
Village of MARIBEL Ward 1	town
Village of MISHICOT Wards 1-4	town
Village of REEDSVILLE Wards 1-3	town
Village of ST. NAZIANZ Ward 1	town
Village of VALDERS Ward 1	town
Village of WHITELAW Ward 1	town
City of KIEL Wards 1-6,8-9,11	town
City of MANITOWOC Wards 1-2	town
City of MANITOWOC Wards 3-4,22	town
City of MANITOWOC Wards 5-6	town
City of MANITOWOC Wards 7-8	town
City of MANITOWOC Wards 9-10,29	town
City of MANITOWOC Wards 11-12	town
City of MANITOWOC Wards 13-14,31	town
City of MANITOWOC Wards 15-16	town
City of MANITOWOC Wards 17-18,21,23-26,28,32	town
City of MANITOWOC Wards 19-20,27,30	town
City of TWO RIVERS Wards 1-2	town
City of TWO RIVERS Wards 3-4	town
City of TWO RIVERS Wards 5-6	town
City of TWO RIVERS Wards 7-8	town
Town of BERGEN Ward 1	town
Town of BERLIN Wards 1-2	town
Town of BERN Ward 1	town
Town of BEVENT Wards 1-2	town
Town of BRIGHTON Ward 1	town
Town of CASSEL Ward 1	town
Town of CLEVELAND Wards 1-2	town
Town of DAY Wards 1-2	town
Town of EAU PLEINE Ward 1	town
Town of ELDERON Ward 1	town
Town of FRANKFORT Ward 1	town
Town of FRANZEN Ward 1	town
Town of GREEN VALLEY Ward 1	town
Town of GUENTHER Ward 1	town
Town of HALSEY Ward 1	town
Town of HAMBURG Ward 1	town
Town of HEWITT Ward 1	town
Town of HOLTON Ward 1	town
Town of HULL Ward 1	town
Town of JOHNSON Ward 1	town
Town of KNOWLTON Wards 1-3	town
Town of MARATHON Wards 1-2	town
Town of MCMILLAN Wards 1-3	town
Town of MOSINEE Wards 1-3	town
Town of NORRIE Ward 1	town
Town of PLOVER Ward 1	town
Town of REID Wards 1-2	town
Town of RIB FALLS Ward 1	town
Town of RIB MOUNTAIN Wards 1-10	town
Town of RIETBROCK Ward 1	town
Town of RINGLE Wards 1-2	town
Town of SPENCER Wards 1-2	town
Town of STETTIN Wards 1-4	town
Town of STETTIN Ward 5	town
Town of TEXAS Wards 1-2	town
Town of WAUSAU Wards 1-3	town
Town of WESTON Ward 1	town
Town of WIEN Ward 1	town
Village of ATHENS Wards 1-2	town
VILLAGE OF BIRNAMWOOD Ward 2	town
VILLAGE OF DORCHESTER Ward 2	town
VILLAGE OF DORCHESTER Ward 3	town
Village of EDGAR Wards 1-2	town
Village of ELDERON Ward 1	town
Village of FENWOOD Ward 1	town
Village of HATLEY Ward 1	town
Village of KRONENWETTER Wards 1-5	town
Village of KRONENWETTER Wards 6-10	town
Village of Maine Wards 1-4	town
Village of MARATHON CITY Wards 1-3	town
Village of MARATHON CITY Ward 4	town
Village of ROTHSCHILD Wards 1-3	town
Village of ROTHSCHILD Wards 4-6	town
Village of ROTHSCHILD Ward 7	town
Village of SPENCER Wards 1-3	town
Village of STRATFORD Wards 1-2	town
Village of UNITY Ward 1	town
Village of WESTON Wards 1-13	town
CITY OF ABBOTSFORD Wards 1,6	town
CITY OF COLBY Ward 1	town
CITY OF MARSHFIELD Wards 12,20-21,24	town
City of MOSINEE Wards 1-2,6-7	town
City of MOSINEE Wards 3-5	town
City of SCHOFIELD Wards 1-4	town
City of WAUSAU Ward 1	town
City of WAUSAU Ward 2	town
City of WAUSAU Ward 3	town
City of WAUSAU Ward 4	town
City of WAUSAU Ward 5	town
City of WAUSAU Ward 6	town
City of WAUSAU Ward 7	town
City of WAUSAU Ward 8	town
City of WAUSAU Ward 9	town
City of WAUSAU Ward 10	town
City of WAUSAU Ward 11	town
City of WAUSAU Ward 12	town
City of WAUSAU Ward 13	town
City of WAUSAU Ward 14	town
City of WAUSAU Ward 15	town
City of WAUSAU Ward 16	town
City of WAUSAU Ward 17	town
City of WAUSAU Ward 18	town
City of WAUSAU Ward 19	town
City of WAUSAU Ward 20	town
City of WAUSAU Ward 21	town
City of WAUSAU Ward 22	town
City of WAUSAU Ward 23	town
City of WAUSAU Ward 24	town
City of WAUSAU Ward 25	town
City of WAUSAU Ward 26	town
City of WAUSAU Ward 27	town
City of WAUSAU Ward 28	town
City of WAUSAU Ward 29	town
City of WAUSAU Ward 30	town
City of WAUSAU Ward 31	town
City of WAUSAU Ward 32	town
City of WAUSAU Ward 33	town
City of WAUSAU Ward 34	town
City of WAUSAU Ward 35	town
City of WAUSAU Ward 36	town
City of WAUSAU Ward 37	town
City of WAUSAU Ward 38	town
City of WAUSAU Ward 48	town
City of WAUSAU Ward 49	town
City of WAUSAU Ward 50	town
City of WAUSAU Ward 51	town
Town of AMBERG Ward 1	town
Town of ATHELSTANE Wards 1-2	town
Town of BEAVER Wards 1-2	town
Town of BEECHER Ward 1	town
Town of DUNBAR Wards 1-2	town
Town of GOODMAN Ward 1	town
Town of GROVER Wards 1-3	town
Town of LAKE Wards 1-2	town
Town of MIDDLE INLET Wards 1-2	town
Town of NIAGARA Ward 1	town
Town of PEMBINE Wards 1-2	town
Town of PESHTIGO Wards 1,4	town
Town of PESHTIGO Wards 2-3	town
Town of PESHTIGO Wards 5-6	town
Town of PORTERFIELD Wards 1-3	town
Town of POUND Wards 1-3	town
Town of SILVER CLIFF Ward 1	town
Town of STEPHENSON Wards 1-3	town
Town of STEPHENSON Wards 4-5	town
Town of WAGNER Ward 1	town
Town of WAUSAUKEE Wards 1-2	town
Village of COLEMAN Ward 1	town
Village of CRIVITZ Ward 1	town
Village of POUND Ward 1	town
Village of WAUSAUKEE Ward 1	town
City of MARINETTE Wards 1-8	town
City of NIAGARA Wards 1-3	town
City of PESHTIGO Wards 1-7	town
Town of BUFFALO Wards 1-2	town
Town of DOUGLAS Ward 1	town
Town of HARRIS Ward 1	town
Town of MECAN Ward 1	town
Town of MONTELLO Wards 1-4	town
Town of MOUNDVILLE Wards 1-2	town
Town of NESHKORO Wards 1-2	town
Town of NEWTON Wards 1-2	town
Town of OXFORD Wards 1-2	town
Town of PACKWAUKEE Wards 1-3	town
Town of WESTFIELD Wards 1-2	town
Village of ENDEAVOR Ward 1	town
Village of NESHKORO Ward 1	town
Village of OXFORD Ward 1	town
Village of WESTFIELD Wards 1-2	town
City of MONTELLO Wards 1-4	town
Town of MENOMINEE Wards 1,3-5	town
Town of MENOMINEE Ward 2	town
Village of BAYSIDE Wards 1,3	town
Village of BAYSIDE Wards 1S,3S	town
Village of BAYSIDE Wards 2,4	town
Village of BAYSIDE Ward 5	town
Village of BROWN DEER Wards 1-2	town
Village of BROWN DEER Wards 3-4	town
Village of BROWN DEER Wards 5-6	town
Village of FOX POINT Wards 1-4	town
Village of FOX POINT Wards 5-9	town
Village of GREENDALE Wards 1-2	town
Village of GREENDALE Wards 3-4	town
Village of GREENDALE Wards 5-6	town
Village of GREENDALE Wards 7-8	town
Village of GREENDALE Wards 9-10	town
Village of HALES CORNERS Wards 1-3	town
Village of HALES CORNERS Wards 4-6	town
Village of HALES CORNERS Wards 7-9	town
Village of RIVER HILLS Wards 1-3	town
Village of SHOREWOOD Wards 1-4	town
Village of SHOREWOOD Wards 5-8	town
Village of SHOREWOOD Wards 9-12	town
Village of WEST MILWAUKEE Wards 1-2,5	town
Village of WEST MILWAUKEE Wards 3-4,6	town
Village of WHITEFISH BAY Wards 1-2	town
Village of WHITEFISH BAY Wards 3-4	town
Village of WHITEFISH BAY Wards 5-6	town
Village of WHITEFISH BAY Ward 7	town
Village of WHITEFISH BAY Wards 8,10	town
Village of WHITEFISH BAY Wards 9,11	town
Village of WHITEFISH BAY Ward 12	town
City of CUDAHY Wards 1-3	town
City of CUDAHY Wards 4-6	town
City of CUDAHY Wards 7-9	town
City of CUDAHY Wards 10-12	town
City of CUDAHY Wards 13-15	town
City of FRANKLIN Ward 1	town
City of FRANKLIN Ward 2	town
City of FRANKLIN Ward 3	town
City of FRANKLIN Ward 4	town
City of FRANKLIN Ward 5	town
City of FRANKLIN Ward 6	town
City of FRANKLIN Ward 7	town
City of FRANKLIN Ward 8	town
City of FRANKLIN Ward 9	town
City of FRANKLIN Ward 10	town
City of FRANKLIN Ward 11	town
City of FRANKLIN Ward 12	town
City of FRANKLIN Ward 13	town
City of FRANKLIN Ward 14	town
City of FRANKLIN Ward 15A	town
City of FRANKLIN Ward 15B	town
City of FRANKLIN Ward 16	town
City of FRANKLIN Ward 17	town
City of FRANKLIN Ward 18	town
City of FRANKLIN Ward 19	town
City of FRANKLIN Ward 20	town
City of FRANKLIN Ward 21	town
City of FRANKLIN Ward 22A	town
City of FRANKLIN Ward 22B	town
City of FRANKLIN Ward 23	town
City of GLENDALE Wards 1,7	town
City of GLENDALE Wards 2,8S	town
City of GLENDALE Wards 3,9	town
City of GLENDALE Wards 4,10	town
City of GLENDALE Wards 5,11	town
City of GLENDALE Wards 6,12	town
City of GLENDALE Ward 8	town
City of GLENDALE Ward 11S	town
City of GREENFIELD Ward 1	town
City of GREENFIELD Ward 2	town
City of GREENFIELD Ward 3	town
City of GREENFIELD Ward 4	town
City of GREENFIELD Ward 5	town
City of GREENFIELD Ward 6	town
City of GREENFIELD Ward 7	town
City of GREENFIELD Ward 8	town
City of GREENFIELD Ward 9	town
City of GREENFIELD Ward 10	town
City of GREENFIELD Ward 11	town
City of GREENFIELD Ward 12	town
City of GREENFIELD Ward 13	town
City of GREENFIELD Ward 14	town
City of GREENFIELD Ward 15	town
City of GREENFIELD Ward 16	town
City of GREENFIELD Ward 17	town
City of GREENFIELD Ward 18	town
City of GREENFIELD Ward 19	town
City of GREENFIELD Ward 20	town
City of GREENFIELD Ward 21	town
City of MILWAUKEE Ward 1	town
City of MILWAUKEE Ward 2	town
City of MILWAUKEE Ward 3	town
City of MILWAUKEE Ward 4	town
City of MILWAUKEE Ward 5	town
City of MILWAUKEE Ward 6	town
City of MILWAUKEE Ward 7	town
City of MILWAUKEE Ward 8	town
City of MILWAUKEE Ward 9	town
City of MILWAUKEE Ward 10	town
City of MILWAUKEE Ward 11	town
City of MILWAUKEE Ward 12	town
City of MILWAUKEE Ward 13	town
City of MILWAUKEE Ward 14	town
City of MILWAUKEE Ward 15	town
City of MILWAUKEE Ward 16	town
City of MILWAUKEE Ward 17	town
City of MILWAUKEE Ward 18	town
City of MILWAUKEE Ward 19	town
City of MILWAUKEE Ward 20	town
City of MILWAUKEE Ward 21	town
City of MILWAUKEE Ward 22	town
City of MILWAUKEE Ward 23	town
City of MILWAUKEE Ward 24	town
City of MILWAUKEE Ward 25	town
City of MILWAUKEE Ward 26	town
City of MILWAUKEE Ward 27	town
City of MILWAUKEE Ward 28	town
City of MILWAUKEE Ward 29	town
City of MILWAUKEE Ward 30	town
City of MILWAUKEE Ward 31	town
City of MILWAUKEE Ward 32	town
City of MILWAUKEE Ward 33	town
City of MILWAUKEE Ward 34	town
City of MILWAUKEE Ward 35	town
City of MILWAUKEE Ward 36	town
City of MILWAUKEE Ward 37	town
City of MILWAUKEE Ward 38	town
City of MILWAUKEE Ward 39	town
City of MILWAUKEE Ward 40	town
City of MILWAUKEE Ward 41	town
City of MILWAUKEE Ward 42	town
City of MILWAUKEE Ward 43	town
City of MILWAUKEE Ward 44	town
City of MILWAUKEE Ward 45	town
City of MILWAUKEE Ward 46	town
City of MILWAUKEE Ward 47	town
City of MILWAUKEE Ward 48	town
City of MILWAUKEE Ward 49	town
City of MILWAUKEE Ward 50	town
City of MILWAUKEE Ward 51	town
City of MILWAUKEE Ward 52	town
City of MILWAUKEE Ward 53	town
City of MILWAUKEE Ward 54	town
City of MILWAUKEE Ward 55	town
City of MILWAUKEE Ward 56	town
City of MILWAUKEE Ward 57	town
City of MILWAUKEE Ward 58	town
City of MILWAUKEE Ward 59	town
City of MILWAUKEE Ward 60	town
City of MILWAUKEE Ward 61	town
City of MILWAUKEE Ward 62	town
City of MILWAUKEE Ward 63	town
City of MILWAUKEE Ward 64	town
City of MILWAUKEE Ward 65	town
City of MILWAUKEE Ward 66	town
City of MILWAUKEE Ward 67	town
City of MILWAUKEE Ward 68	town
City of MILWAUKEE Ward 69	town
City of MILWAUKEE Ward 70	town
City of MILWAUKEE Ward 71	town
City of MILWAUKEE Ward 72	town
City of MILWAUKEE Ward 73	town
City of MILWAUKEE Ward 74	town
City of MILWAUKEE Ward 75	town
City of MILWAUKEE Ward 76	town
City of MILWAUKEE Ward 77	town
City of MILWAUKEE Ward 78	town
City of MILWAUKEE Ward 79	town
City of MILWAUKEE Ward 80	town
City of MILWAUKEE Ward 81	town
City of MILWAUKEE Ward 82	town
City of MILWAUKEE Ward 83	town
City of MILWAUKEE Ward 84	town
City of MILWAUKEE Ward 85	town
City of MILWAUKEE Ward 86	town
City of MILWAUKEE Ward 87	town
City of MILWAUKEE Ward 88	town
City of MILWAUKEE Ward 89	town
City of MILWAUKEE Ward 90	town
City of MILWAUKEE Ward 91	town
City of MILWAUKEE Ward 92	town
City of MILWAUKEE Ward 93	town
City of MILWAUKEE Ward 94	town
City of MILWAUKEE Ward 95	town
City of MILWAUKEE Ward 96	town
City of MILWAUKEE Ward 97	town
City of MILWAUKEE Ward 98	town
City of MILWAUKEE Ward 99	town
City of MILWAUKEE Ward 100	town
City of MILWAUKEE Ward 101	town
City of MILWAUKEE Ward 102	town
City of MILWAUKEE Ward 103	town
City of MILWAUKEE Ward 104	town
City of MILWAUKEE Ward 105	town
City of MILWAUKEE Ward 106	town
City of MILWAUKEE Ward 107	town
City of MILWAUKEE Ward 108	town
City of MILWAUKEE Ward 109	town
City of MILWAUKEE Ward 110	town
City of MILWAUKEE Ward 111	town
City of MILWAUKEE Ward 112	town
City of MILWAUKEE Ward 113	town
City of MILWAUKEE Ward 114	town
City of MILWAUKEE Ward 115	town
City of MILWAUKEE Ward 116	town
City of MILWAUKEE Ward 117	town
City of MILWAUKEE Ward 118	town
City of MILWAUKEE Ward 119	town
City of MILWAUKEE Ward 120	town
City of MILWAUKEE Ward 121	town
City of MILWAUKEE Ward 122	town
City of MILWAUKEE Ward 123	town
City of MILWAUKEE Ward 124	town
City of MILWAUKEE Ward 125	town
City of MILWAUKEE Ward 126	town
City of MILWAUKEE Ward 127	town
City of MILWAUKEE Ward 128	town
City of MILWAUKEE Ward 129	town
City of MILWAUKEE Ward 130	town
City of MILWAUKEE Ward 131	town
City of MILWAUKEE Ward 132	town
City of MILWAUKEE Ward 133	town
City of MILWAUKEE Ward 134	town
City of MILWAUKEE Ward 135	town
City of MILWAUKEE Ward 136	town
City of MILWAUKEE Ward 137	town
City of MILWAUKEE Ward 138	town
City of MILWAUKEE Ward 139	town
City of MILWAUKEE Ward 140	town
City of MILWAUKEE Ward 141	town
City of MILWAUKEE Ward 142	town
City of MILWAUKEE Ward 143	town
City of MILWAUKEE Ward 144	town
City of MILWAUKEE Ward 145	town
City of MILWAUKEE Ward 146	town
City of MILWAUKEE Ward 147	town
City of MILWAUKEE Ward 148	town
City of MILWAUKEE Ward 149	town
City of MILWAUKEE Ward 150	town
City of MILWAUKEE Ward 151	town
City of MILWAUKEE Ward 152	town
City of MILWAUKEE Ward 153	town
City of MILWAUKEE Ward 154	town
City of MILWAUKEE Ward 155	town
City of MILWAUKEE Ward 156	town
City of MILWAUKEE Ward 157	town
City of MILWAUKEE Ward 158	town
City of MILWAUKEE Ward 159	town
City of MILWAUKEE Ward 160	town
City of MILWAUKEE Ward 161	town
City of MILWAUKEE Ward 162	town
City of MILWAUKEE Ward 163	town
City of MILWAUKEE Ward 164	town
City of MILWAUKEE Ward 165	town
City of MILWAUKEE Ward 166	town
City of MILWAUKEE Ward 167	town
City of MILWAUKEE Ward 168	town
City of MILWAUKEE Ward 169	town
City of MILWAUKEE Ward 170	town
City of MILWAUKEE Ward 171	town
City of MILWAUKEE Ward 172	town
City of MILWAUKEE Ward 173	town
City of MILWAUKEE Ward 174	town
City of MILWAUKEE Ward 175	town
City of MILWAUKEE Ward 176	town
City of MILWAUKEE Ward 177	town
City of MILWAUKEE Ward 178	town
City of MILWAUKEE Ward 179	town
City of MILWAUKEE Ward 180	town
City of MILWAUKEE Ward 181	town
City of MILWAUKEE Ward 182	town
City of MILWAUKEE Ward 183	town
City of MILWAUKEE Ward 184	town
City of MILWAUKEE Ward 185	town
City of MILWAUKEE Ward 186	town
City of MILWAUKEE Ward 187	town
City of MILWAUKEE Ward 188	town
City of MILWAUKEE Ward 189	town
City of MILWAUKEE Ward 190	town
City of MILWAUKEE Ward 191	town
City of MILWAUKEE Ward 192	town
City of MILWAUKEE Ward 193	town
City of MILWAUKEE Ward 194	town
City of MILWAUKEE Ward 195	town
City of MILWAUKEE Ward 196	town
City of MILWAUKEE Ward 197	town
City of MILWAUKEE Ward 198	town
City of MILWAUKEE Ward 199	town
City of MILWAUKEE Ward 200	town
City of MILWAUKEE Ward 201	town
City of MILWAUKEE Ward 202	town
City of MILWAUKEE Ward 203	town
City of MILWAUKEE Ward 204	town
City of MILWAUKEE Ward 205	town
City of MILWAUKEE Ward 206	town
City of MILWAUKEE Ward 207	town
City of MILWAUKEE Ward 208	town
City of MILWAUKEE Ward 209	town
City of MILWAUKEE Ward 210	town
City of MILWAUKEE Ward 211	town
City of MILWAUKEE Ward 212	town
City of MILWAUKEE Ward 213	town
City of MILWAUKEE Ward 214	town
City of MILWAUKEE Ward 215	town
City of MILWAUKEE Ward 216	town
City of MILWAUKEE Ward 217	town
City of MILWAUKEE Ward 218	town
City of MILWAUKEE Ward 219	town
City of MILWAUKEE Ward 220	town
City of MILWAUKEE Ward 221	town
City of MILWAUKEE Ward 222	town
City of MILWAUKEE Ward 223	town
City of MILWAUKEE Ward 224	town
City of MILWAUKEE Ward 225	town
City of MILWAUKEE Ward 226	town
City of MILWAUKEE Ward 227	town
City of MILWAUKEE Ward 228	town
City of MILWAUKEE Ward 229	town
City of MILWAUKEE Ward 230	town
City of MILWAUKEE Ward 231	town
City of MILWAUKEE Ward 232	town
City of MILWAUKEE Ward 233	town
City of MILWAUKEE Ward 234	town
City of MILWAUKEE Ward 235	town
City of MILWAUKEE Ward 236	town
City of MILWAUKEE Ward 237	town
City of MILWAUKEE Ward 238	town
City of MILWAUKEE Ward 239	town
City of MILWAUKEE Ward 240	town
City of MILWAUKEE Ward 241	town
City of MILWAUKEE Ward 242	town
City of MILWAUKEE Ward 243	town
City of MILWAUKEE Ward 244	town
City of MILWAUKEE Ward 245	town
City of MILWAUKEE Ward 246	town
City of MILWAUKEE Ward 247	town
City of MILWAUKEE Ward 248	town
City of MILWAUKEE Ward 249	town
City of MILWAUKEE Ward 250	town
City of MILWAUKEE Ward 251	town
City of MILWAUKEE Ward 252	town
City of MILWAUKEE Ward 253	town
City of MILWAUKEE Ward 254	town
City of MILWAUKEE Ward 255	town
City of MILWAUKEE Ward 256	town
City of MILWAUKEE Ward 257	town
City of MILWAUKEE Ward 258	town
City of MILWAUKEE Ward 259	town
City of MILWAUKEE Ward 260	town
City of MILWAUKEE Ward 261	town
City of MILWAUKEE Ward 262	town
City of MILWAUKEE Ward 263	town
City of MILWAUKEE Ward 264	town
City of MILWAUKEE Ward 265	town
City of MILWAUKEE Ward 266	town
City of MILWAUKEE Ward 267	town
City of MILWAUKEE Ward 268	town
City of MILWAUKEE Ward 269	town
City of MILWAUKEE Ward 270	town
City of MILWAUKEE Ward 271	town
City of MILWAUKEE Ward 272	town
City of MILWAUKEE Ward 273	town
City of MILWAUKEE Ward 274	town
City of MILWAUKEE Ward 275	town
City of MILWAUKEE Ward 276	town
City of MILWAUKEE Ward 277	town
City of MILWAUKEE Ward 278	town
City of MILWAUKEE Ward 279	town
City of MILWAUKEE Ward 280	town
City of MILWAUKEE Ward 281	town
City of MILWAUKEE Ward 282	town
City of MILWAUKEE Ward 283	town
City of MILWAUKEE Ward 284	town
City of MILWAUKEE Ward 285	town
City of MILWAUKEE Ward 286	town
City of MILWAUKEE Ward 287	town
City of MILWAUKEE Ward 288	town
City of MILWAUKEE Ward 289	town
City of MILWAUKEE Ward 290	town
City of MILWAUKEE Ward 291	town
City of MILWAUKEE Ward 292	town
City of MILWAUKEE Ward 293	town
City of MILWAUKEE Ward 294	town
City of MILWAUKEE Ward 295	town
City of MILWAUKEE Ward 296	town
City of MILWAUKEE Ward 297	town
City of MILWAUKEE Ward 298	town
City of MILWAUKEE Ward 299	town
City of MILWAUKEE Ward 300	town
City of MILWAUKEE Ward 301	town
City of MILWAUKEE Ward 302	town
City of MILWAUKEE Ward 303	town
City of MILWAUKEE Ward 304	town
City of MILWAUKEE Ward 305	town
City of MILWAUKEE Ward 306	town
City of MILWAUKEE Ward 307	town
City of MILWAUKEE Ward 308	town
City of MILWAUKEE Ward 309	town
City of MILWAUKEE Ward 310	town
City of MILWAUKEE Ward 311	town
City of MILWAUKEE Ward 312	town
City of MILWAUKEE Ward 313	town
City of MILWAUKEE Ward 314	town
City of MILWAUKEE Ward 315	town
City of MILWAUKEE Ward 316	town
City of MILWAUKEE Ward 317	town
City of MILWAUKEE Ward 320	town
City of MILWAUKEE Ward 321	town
City of MILWAUKEE Ward 322	town
City of MILWAUKEE Ward 323	town
City of MILWAUKEE Ward 324	town
City of MILWAUKEE Ward 325	town
City of MILWAUKEE Ward 326	town
City of MILWAUKEE Ward 327	town
City of OAK CREEK Wards 1-3	town
City of OAK CREEK Wards 4-6	town
City of OAK CREEK Wards 7-9	town
City of OAK CREEK Wards 10-12	town
City of OAK CREEK Wards 13-15	town
City of OAK CREEK Wards 16-19	town
City of ST. FRANCIS Wards 1-4	town
City of ST. FRANCIS Wards 5-8	town
City of ST. FRANCIS Wards 9-12	town
City of SOUTH MILWAUKEE Wards 1-4	town
City of SOUTH MILWAUKEE Wards 5-8	town
City of SOUTH MILWAUKEE Wards 9-12	town
City of SOUTH MILWAUKEE Wards 13-16	town
City of WAUWATOSA Ward 1	town
City of WAUWATOSA Ward 2	town
City of WAUWATOSA Ward 3	town
City of WAUWATOSA Ward 4	town
City of WAUWATOSA Ward 5	town
City of WAUWATOSA Ward 6	town
City of WAUWATOSA Ward 7	town
City of WAUWATOSA Ward 8	town
City of WAUWATOSA Ward 9	town
City of WAUWATOSA Ward 10	town
City of WAUWATOSA Ward 11	town
City of WAUWATOSA Ward 12	town
City of WAUWATOSA Ward 13	town
City of WAUWATOSA Ward 14	town
City of WAUWATOSA Ward 15	town
City of WAUWATOSA Ward 16	town
City of WAUWATOSA Ward 17	town
City of WAUWATOSA Ward 18	town
City of WAUWATOSA Ward 19	town
City of WAUWATOSA Ward 20	town
City of WAUWATOSA Ward 21	town
City of WAUWATOSA Ward 22	town
City of WAUWATOSA Ward 23	town
City of WAUWATOSA Ward 24	town
City of WEST ALLIS Ward 1	town
City of WEST ALLIS Ward 2	town
City of WEST ALLIS Ward 3	town
City of WEST ALLIS Ward 4	town
City of WEST ALLIS Ward 5	town
City of WEST ALLIS Ward 6	town
City of WEST ALLIS Ward 7	town
City of WEST ALLIS Ward 8	town
City of WEST ALLIS Ward 9	town
City of WEST ALLIS Ward 10	town
City of WEST ALLIS Ward 11	town
City of WEST ALLIS Ward 12	town
City of WEST ALLIS Ward 13	town
City of WEST ALLIS Ward 14	town
City of WEST ALLIS Ward 15	town
City of WEST ALLIS Ward 16	town
City of WEST ALLIS Ward 17	town
City of WEST ALLIS Ward 18	town
City of WEST ALLIS Ward 19	town
City of WEST ALLIS Ward 20	town
City of WEST ALLIS Ward 21	town
City of WEST ALLIS Ward 22	town
City of WEST ALLIS Ward 23	town
City of WEST ALLIS Ward 24	town
City of WEST ALLIS Ward 25	town
Town of ADRIAN Ward 1	town
Town of ANGELO Wards 1-3	town
Town of BYRON Ward 1	town
Town of CLIFTON Ward 1	town
Town of GLENDALE Ward 1	town
Town of GRANT Ward 1	town
Town of JEFFERSON Ward 1	town
Town of LAFAYETTE Wards 1-2	town
Town of LA GRANGE Wards 1A,2A,3A	town
Town of LA GRANGE Wards 1B,2B,3B	town
Town of LEON Wards 1-2	town
Town of LITTLE FALLS Wards 1-2	town
Town of NEW LYME Ward 1	town
Town of OAKDALE Ward 1	town
Town of PORTLAND Ward 1	town
Town of RIDGEVILLE Ward 1	town
Town of SHELDON Ward 1	town
Town of SPARTA Wards 1-6	town
Town of TOMAH Wards 1-2	town
Town of WELLINGTON Wards 1-2	town
Town of WELLS Ward 1	town
Town of WILTON Wards 1-5	town
Village of CASHTON Wards 1-3	town
Village of KENDALL Ward 1	town
Village of MELVINA Ward 1	town
Village of NORWALK Ward 1	town
Village of OAKDALE Ward 1	town
VILLAGE OF ONTARIO Ward 2	town
VILLAGE OF ROCKLAND Ward 2	town
Village of WARRENS Ward 1	town
Village of WILTON Ward 1	town
Village of WYEVILLE Ward 1	town
City of SPARTA Wards 1-6	town
City of SPARTA Wards 7-12	town
City of SPARTA Wards 13-18,20-23	town
City of SPARTA Ward 19	town
City of TOMAH Wards 1-5A,6	town
City of TOMAH Wards 5B,24	town
City of TOMAH Wards 7-11,18	town
City of TOMAH Wards 12-16	town
City of TOMAH Wards 17,19-23	town
Town of ABRAMS Wards 1-3	town
Town of BAGLEY Ward 1	town
Town of BRAZEAU Wards 1-3	town
Town of BREED Ward 1	town
Town of CHASE Wards 1-5	town
Town of DOTY Ward 1	town
Town of GILLETT Wards 1-2	town
Town of HOW Wards 1-2	town
Town of LAKEWOOD Ward 1	town
Town of LENA Ward 1	town
Town of LITTLE RIVER Wards 1-2	town
Town of LITTLE SUAMICO Wards 1-8	town
Town of MAPLE VALLEY Ward 1	town
Town of MORGAN Wards 1-2	town
Town of MOUNTAIN Ward 1	town
Town of OCONTO Wards 1-3	town
Town of OCONTO FALLS Wards 1-2	town
Town of PENSAUKEE Wards 1-2	town
Town of RIVERVIEW Wards 1-2	town
Town of SPRUCE Wards 1-2	town
Town of STILES Wards 1-2	town
Town of TOWNSEND Ward 1	town
Town of UNDERHILL Ward 1	town
Village of LENA Ward 1	town
VILLAGE OF PULASKI Ward 5	town
Village of SURING Ward 1	town
City of GILLETT Wards 1-3	town
City of OCONTO Wards 1-7	town
City of OCONTO FALLS Wards 1-5	town
City of OCONTO FALLS Ward 6	town
Town of CASSIAN Wards 1-2	town
Town of CRESCENT Wards 1-3	town
Town of ENTERPRISE Ward 1	town
Town of HAZELHURST Wards 1-2	town
Town of LAKE TOMAHAWK Wards 1-2	town
Town of LITTLE RICE Ward 1	town
Town of LYNNE Ward 1	town
Town of MINOCQUA Wards 1-7	town
Town of MONICO Ward 1	town
Town of NEWBOLD Ward 1	town
Town of NEWBOLD Wards 2-4	town
Town of NOKOMIS Wards 1-2	town
Town of PELICAN Wards 1-4	town
Town of PIEHL Ward 1	town
Town of PINE LAKE Wards 1-4	town
Town of SCHOEPKE Ward 1	town
Town of STELLA Wards 1-2	town
Town of SUGAR CAMP Wards 1-2	town
Town of THREE LAKES Wards 1-4	town
Town of WOODBORO Ward 1	town
Town of WOODRUFF Wards 1-3	town
City of RHINELANDER Ward 1	town
City of RHINELANDER Wards 2-3	town
City of RHINELANDER Wards 4-5	town
City of RHINELANDER Wards 6-7	town
City of RHINELANDER Wards 8-9	town
City of RHINELANDER Ward 10	town
City of RHINELANDER Wards 11-12	town
City of RHINELANDER Wards 13-14	town
Town of BLACK CREEK Wards 1-2	town
Town of BOVINA Wards 1-2	town
Town of BUCHANAN Wards 1-10	town
Town of CENTER Wards 1-7	town
Town of CICERO Wards 1-2	town
Town of DALE Wards 1-3	town
Town of DEER CREEK Ward 1	town
Town of ELLINGTON Wards 1-5	town
Town of FREEDOM Wards 1-8	town
Town of GRAND CHUTE Wards 1-3,15-17	town
Town of GRAND CHUTE Wards 4-6,9-14	town
Town of GRAND CHUTE Wards 7-8	town
Town of GRAND CHUTE Ward 18	town
Town of GREENVILLE Wards 1-3,5	town
Town of GREENVILLE Ward 4	town
Town of GREENVILLE Ward 6	town
Town of GREENVILLE Ward 7	town
Town of GREENVILLE Ward 8	town
Town of GREENVILLE Ward 9	town
Town of HORTONIA Wards 1-2	town
Town of KAUKAUNA Wards 1-3	town
Town of MAINE Ward 1	town
Town of MAPLE CREEK Ward 1	town
Town of ONEIDA Wards 1-6	town
Town of OSBORN Wards 1-2	town
Town of VANDENBROEK Wards 1-3	town
Village of BEAR CREEK Ward 1	town
Village of BLACK CREEK Wards 1-2	town
Village of COMBINED LOCKS Wards 1-6	town
VILLAGE OF HARRISON Wards 1-2	town
Village of HORTONVILLE Wards 1-3	town
VILLAGE OF HOWARD Ward 17	town
Village of KIMBERLY Wards 1-9	town
Village of LITTLE CHUTE Wards 1,4-5,14	town
Village of LITTLE CHUTE Wards 2,6,8,12-13	town
Village of LITTLE CHUTE Wards 3,9-11	town
Village of LITTLE CHUTE Ward 7	town
Village of LITTLE CHUTE Wards 15-16	town
Village of NICHOLS Ward 1	town
Village of SHIOCTON Ward 1	town
VILLAGE OF WRIGHTSTOWN Ward 4	town
VILLAGE OF WRIGHTSTOWN Ward 5	town
City of APPLETON Ward 1	town
City of APPLETON Ward 2	town
City of APPLETON Ward 3	town
City of APPLETON Ward 4	town
City of APPLETON Ward 5	town
City of APPLETON Ward 6	town
City of APPLETON Ward 7	town
City of APPLETON Ward 8	town
City of APPLETON Ward 9	town
City of APPLETON Ward 10	town
City of APPLETON Ward 11	town
City of APPLETON Ward 15	town
City of APPLETON Ward 16	town
City of APPLETON Ward 17	town
City of APPLETON Ward 18	town
City of APPLETON Ward 19	town
City of APPLETON Ward 20	town
City of APPLETON Ward 21	town
City of APPLETON Ward 22	town
City of APPLETON Ward 23	town
City of APPLETON Ward 24	town
City of APPLETON Ward 25	town
City of APPLETON Ward 27	town
City of APPLETON Ward 28	town
City of APPLETON Ward 29	town
City of APPLETON Ward 30	town
City of APPLETON Ward 33	town
City of APPLETON Ward 34	town
City of APPLETON Ward 35	town
City of APPLETON Ward 36	town
City of APPLETON Ward 37	town
City of APPLETON Ward 38	town
City of APPLETON Ward 39	town
City of APPLETON Ward 40	town
City of APPLETON Ward 41	town
City of APPLETON Ward 42	town
City of APPLETON Ward 43	town
City of APPLETON Ward 48	town
City of APPLETON Ward 49	town
City of APPLETON Ward 50	town
City of APPLETON Ward 51	town
City of APPLETON Ward 52	town
City of APPLETON Ward 53	town
City of APPLETON Ward 54	town
City of APPLETON Ward 55	town
City of APPLETON Ward 56	town
City of APPLETON Ward 57	town
City of APPLETON Ward 58	town
City of APPLETON Ward 59	town
City of APPLETON Ward 60	town
City of APPLETON Ward 61	town
City of KAUKAUNA Wards 1-5	town
City of KAUKAUNA Wards 6-10	town
City of KAUKAUNA Wards 12,14	town
City of KAUKAUNA Wards 13,15	town
CITY OF NEW LONDON Wards 1-2	town
City of SEYMOUR Wards 1-6	town
Town of BELGIUM Wards 1-3	town
Town of CEDARBURG Wards 1-2	town
Town of CEDARBURG Wards 3-4	town
Town of CEDARBURG Wards 5-6,10	town
Town of CEDARBURG Wards 7-9	town
Town of FREDONIA Wards 1-4	town
Town of GRAFTON Wards 1-2,5	town
Town of GRAFTON Wards 3-4	town
Town of PORT WASHINGTON Wards 1-2	town
Town of SAUKVILLE Wards 1-3	town
VILLAGE OF BAYSIDE Ward 6	town
Village of BELGIUM Wards 1-3	town
Village of FREDONIA Wards 1-3	town
Village of GRAFTON Wards 1-2	town
Village of GRAFTON Wards 3-4	town
Village of GRAFTON Wards 5-6	town
Village of GRAFTON Wards 7-8	town
Village of GRAFTON Wards 9-10	town
Village of GRAFTON Wards 11-12	town
Village of GRAFTON Wards 13-14	town
VILLAGE OF NEWBURG Ward 3	town
Village of SAUKVILLE Wards 1,6-7	town
Village of SAUKVILLE Wards 2-5	town
Village of THIENSVILLE Wards 1-2	town
Village of THIENSVILLE Wards 3-4	town
City of CEDARBURG Ward 1	town
City of CEDARBURG Wards 2,9	town
City of CEDARBURG Ward 3	town
City of CEDARBURG Wards 4,8	town
City of CEDARBURG Ward 5	town
City of CEDARBURG Ward 6	town
City of CEDARBURG Ward 7	town
City of MEQUON Ward 1	town
City of MEQUON Ward 2	town
City of MEQUON Wards 3-4	town
City of MEQUON Wards 5,7B	town
City of MEQUON Wards 6-7A	town
City of MEQUON Wards 8-10	town
City of MEQUON Wards 11-12	town
City of MEQUON Wards 13-14	town
City of MEQUON Ward 15	town
City of MEQUON Wards 16-17	town
City of MEQUON Ward 18	town
City of MEQUON Wards 19-21	town
City of PORT WASHINGTON Ward 1	town
City of PORT WASHINGTON Ward 2	town
City of PORT WASHINGTON Ward 3	town
City of PORT WASHINGTON Ward 4	town
City of PORT WASHINGTON Ward 5	town
City of PORT WASHINGTON Ward 6	town
City of PORT WASHINGTON Ward 7	town
Town of ALBANY Ward 1	town
Town of DURAND Wards 1-2	town
Town of LIMA Wards 1-2	town
Town of PEPIN Wards 1-2	town
Town of STOCKHOLM Ward 1	town
Town of WATERVILLE Wards 1-2	town
Town of WAUBEEK Ward 1	town
Village of PEPIN Wards 1-2	town
Village of STOCKHOLM Ward 1	town
City of DURAND Wards 1-3	town
Town of CLIFTON Wards 1-3	town
Town of DIAMOND BLUFF Ward 1	town
Town of ELLSWORTH Wards 1-2	town
Town of EL PASO Ward 1	town
Town of GILMAN Ward 1	town
Town of HARTLAND Ward 1	town
Town of ISABELLE Ward 1	town
Town of MAIDEN ROCK Ward 1	town
Town of MARTELL Wards 1-2	town
Town of OAK GROVE Wards 1-3	town
Town of RIVER FALLS Wards 1-3	town
Town of ROCK ELM Ward 1	town
Town of SALEM Ward 1	town
Town of SPRING LAKE Wards 1-2	town
Town of TRIMBELLE Wards 1-2	town
Village of BAY CITY Ward 1	town
Village of ELLSWORTH Wards 1-4	town
Village of ELMWOOD Ward 1	town
Village of MAIDEN ROCK Ward 1	town
Village of PLUM CITY Ward 1	town
Village of SPRING VALLEY Wards 1-2	town
City of PRESCOTT Wards 1-6	town
City of RIVER FALLS Ward 5	town
City of RIVER FALLS Wards 6-8	town
City of RIVER FALLS Wards 9-11	town
City of RIVER FALLS Wards 12-14	town
Town of ALDEN Wards 1-4	town
Town of APPLE RIVER Wards 1-2	town
Town of BALSAM LAKE Wards 1-2	town
Town of BLACK BROOK Wards 1-2	town
Town of BONE LAKE Ward 1	town
Town of CLAM FALLS Ward 1	town
Town of CLAYTON Ward 1	town
Town of CLEAR LAKE Ward 1	town
Town of EUREKA Wards 1-2	town
Town of GARFIELD Wards 1-3	town
Town of GEORGETOWN Wards 1-2	town
Town of JOHNSTOWN Ward 1	town
Town of LAKETOWN Ward 1	town
Town of LINCOLN Wards 1-4	town
Town of LORAIN Ward 1	town
Town of LUCK Wards 1-2	town
Town of MCKINLEY Ward 1	town
Town of MILLTOWN Wards 1-2	town
Town of OSCEOLA Wards 1-5	town
Town of ST. CROIX FALLS Wards 1-2	town
Town of STERLING Ward 1	town
Town of WEST SWEDEN Ward 1	town
Village of BALSAM LAKE Wards 1-2	town
Village of CENTURIA Ward 1	town
Village of CLAYTON Ward 1	town
Village of CLEAR LAKE Wards 1-2	town
Village of DRESSER Ward 1	town
Village of FREDERIC Wards 1-2	town
Village of LUCK Wards 1-2	town
Village of MILLTOWN Ward 1	town
Village of OSCEOLA Wards 1-3	town
VILLAGE OF TURTLE LAKE Ward 2A	town
VILLAGE OF TURTLE LAKE Ward 2B	town
City of AMERY Wards 1-5	town
City of ST. CROIX FALLS Wards 1-4	town
Town of ALBAN Ward 1	town
Town of ALMOND Ward 1	town
Town of AMHERST Wards 1-2	town
Town of BELMONT Ward 1	town
Town of BUENA VISTA Wards 1-2	town
Town of CARSON Wards 1-2	town
Town of GRANT Wards 1-2,4	town
Town of GRANT Ward 3	town
Town of HULL Wards 1-3	town
Town of HULL Wards 4-5	town
Town of HULL Wards 6-8	town
Town of LANARK Wards 1-2	town
Town of LINWOOD Wards 1-2	town
Town of NEW HOPE Ward 1	town
Town of PINE GROVE Wards 1-2	town
Town of PLOVER Wards 1-3	town
Town of SHARON Wards 1-3	town
Town of STOCKTON Wards 1-5	town
Village of ALMOND Ward 1	town
Village of AMHERST Wards 1-2	town
Village of AMHERST JUNCTION Ward 1	town
Village of JUNCTION CITY Ward 1	town
VILLAGE OF MILLADORE Ward 2	town
Village of NELSONVILLE Ward 1	town
Village of PARK RIDGE Ward 1	town
Village of PLOVER Wards 1-3	town
Village of PLOVER Wards 4-6	town
Village of PLOVER Wards 7-9	town
Village of ROSHOLT Ward 1	town
Village of WHITING Wards 1-4	town
City of STEVENS POINT Wards 1-3	town
City of STEVENS POINT Wards 4-6	town
City of STEVENS POINT Wards 7-9	town
City of STEVENS POINT Wards 10-12	town
City of STEVENS POINT Wards 13-15	town
City of STEVENS POINT Wards 16-18	town
City of STEVENS POINT Wards 19-21	town
City of STEVENS POINT Wards 22-24	town
City of STEVENS POINT Wards 25-27	town
City of STEVENS POINT Wards 28-30	town
City of STEVENS POINT Wards 31-33	town
City of STEVENS POINT Wards 34,42	town
City of STEVENS POINT Wards 35,40,43,46-47	town
City of STEVENS POINT Wards 36,38,41,45	town
City of STEVENS POINT Wards 37,39,44	town
Town of CATAWBA Ward 1	town
Town of EISENSTEIN Wards 1-2	town
Town of ELK Wards 1-2	town
Town of EMERY Ward 1	town
Town of FIFIELD Ward 1	town
Town of FIFIELD Ward 2	town
Town of FLAMBEAU Ward 1	town
Town of GEORGETOWN Ward 1	town
Town of HACKETT Ward 1	town
Town of HARMONY Ward 1	town
Town of HILL Ward 1	town
Town of KENNAN Ward 1	town
Town of KNOX Ward 1	town
Town of OGEMA Ward 1	town
Town of PRENTICE Ward 1	town
Town of SPIRIT Ward 1	town
Town of WORCESTER Wards 1-3	town
Village of CATAWBA Ward 1	town
Village of KENNAN Ward 1	town
Village of PRENTICE Ward 1	town
City of PARK FALLS Wards 1-7	town
City of PHILLIPS Wards 1-4	town
Town of BURLINGTON Wards 1-7	town
Town of BURLINGTON Wards 8-10	town
Town of BURLINGTON Ward 11	town
Town of DOVER Wards 1-8	town
Town of NORWAY Wards 1-11	town
Town of WATERFORD Wards 1-10	town
Village of CALEDONIA Wards 1-2	town
Village of CALEDONIA Wards 3,4-5	town
Village of CALEDONIA Ward 3B	town
Village of CALEDONIA Wards 6-8	town
Village of CALEDONIA Wards 9-10,12-13	town
Village of CALEDONIA Wards 11,14-15,17	town
Village of CALEDONIA Wards 16,18-19	town
Village of CALEDONIA Ward 20	town
Village of ELMWOOD PARK Ward 1	town
Village of MOUNT PLEASANT Wards 1,17,20	town
Village of MOUNT PLEASANT Wards 2-4,11	town
Village of MOUNT PLEASANT Ward 5	town
Village of MOUNT PLEASANT Wards 6-8	town
Village of MOUNT PLEASANT Wards 9,13-14	town
Village of MOUNT PLEASANT Wards 10,12,15-16	town
Village of MOUNT PLEASANT Wards 18,23	town
Village of MOUNT PLEASANT Wards 19,21-22	town
Village of NORTH BAY Ward 1	town
Village of Raymond Wards 1-6	town
Village of ROCHESTER Wards 1-6	town
Village of STURTEVANT Wards 1-8	town
Village of UNION GROVE Wards 1-7	town
Village of WATERFORD Wards 1-7	town
Village of WIND POINT Wards 1-3	town
Village of Yorkville Wards 1-5	town
City of BURLINGTON Wards 1-4	town
City of BURLINGTON Wards 5-8	town
City of RACINE Ward 1	town
City of RACINE Ward 2	town
City of RACINE Ward 3	town
City of RACINE Ward 4	town
City of RACINE Ward 5	town
City of RACINE Ward 6	town
City of RACINE Ward 7	town
City of RACINE Ward 8	town
City of RACINE Ward 9	town
City of RACINE Ward 10	town
City of RACINE Ward 11	town
City of RACINE Ward 12	town
City of RACINE Ward 13	town
City of RACINE Ward 14	town
City of RACINE Ward 15	town
City of RACINE Ward 16	town
City of RACINE Ward 17	town
City of RACINE Ward 18	town
City of RACINE Ward 19	town
City of RACINE Ward 20	town
City of RACINE Ward 21	town
City of RACINE Ward 22	town
City of RACINE Ward 23	town
City of RACINE Ward 24	town
City of RACINE Ward 25	town
City of RACINE Ward 26	town
City of RACINE Ward 27	town
City of RACINE Ward 28	town
City of RACINE Ward 29	town
City of RACINE Ward 30	town
City of RACINE Ward 31	town
City of RACINE Ward 32	town
City of RACINE Ward 33	town
City of RACINE Ward 34	town
City of RACINE Ward 35	town
City of RACINE Ward 36	town
Town of AKAN Ward 1	town
Town of BLOOM Ward 1	town
Town of BUENA VISTA Wards 1-3	town
Town of BUENA VISTA Ward 4	town
Town of DAYTON Ward 1	town
Town of EAGLE Ward 1	town
Town of FOREST Ward 1	town
Town of HENRIETTA Ward 1	town
Town of ITHACA Ward 1	town
Town of MARSHALL Wards 1-2	town
Town of ORION Ward 1	town
Town of RICHLAND Wards 1-4	town
Town of RICHWOOD Wards 1-2	town
Town of ROCKBRIDGE Wards 1-3	town
Town of SYLVAN Wards 1-2	town
Town of WESTFORD Ward 1	town
Town of WILLOW Ward 1	town
Village of BOAZ Ward 1	town
Village of CAZENOVIA Ward 1	town
Village of LONE ROCK Ward 1	town
Village of VIOLA Ward 2	town
Village of YUBA Ward 1	town
City of RICHLAND CENTER Ward 1	town
City of RICHLAND CENTER Ward 2	town
City of RICHLAND CENTER Ward 3	town
City of RICHLAND CENTER Ward 4	town
City of RICHLAND CENTER Ward 5	town
City of RICHLAND CENTER Ward 6	town
City of RICHLAND CENTER Ward 7	town
City of RICHLAND CENTER Ward 8	town
City of RICHLAND CENTER Ward 9	town
City of RICHLAND CENTER Ward 10	town
City of RICHLAND CENTER Ward 11	town
City of RICHLAND CENTER Ward 12	town
City of RICHLAND CENTER Ward 13	town
City of RICHLAND CENTER Ward 14	town
Town of AVON Ward 1	town
Town of BELOIT Wards 1-3	town
Town of BELOIT Wards 4-6	town
Town of BELOIT Wards 7-10	town
Town of BELOIT Ward 11	town
Town of BRADFORD Wards 1-2	town
Town of CENTER Wards 1-2	town
Town of FULTON Wards 1-6	town
Town of HARMONY Wards 2-5	town
Town of HARMONY Ward 6	town
Town of JANESVILLE Wards 1-6	town
Town of JANESVILLE Wards 7-9	town
Town of LA PRAIRIE Ward 1	town
Town of LA PRAIRIE Ward 2	town
Town of MAGNOLIA Ward 1	town
Town of MILTON Wards 2-4	town
Town of NEWARK Wards 1-3	town
Town of PLYMOUTH Wards 1-2	town
Town of PORTER Ward 1	town
Town of ROCK Wards 1-4,6	town
Town of ROCK Wards 5,7	town
Town of ROCK Ward 8	town
Town of SPRING VALLEY Ward 1	town
Town of TURTLE Wards 1,4	town
Town of TURTLE Wards 2-3	town
Village of CLINTON Wards 1-3	town
Village of FOOTVILLE Ward 1	town
Village of ORFORDVILLE Wards 1-2	town
City of BELOIT Ward 1	town
City of BELOIT Ward 2	town
City of BELOIT Ward 3	town
City of BELOIT Ward 4	town
City of BELOIT Ward 5	town
City of BELOIT Ward 6	town
City of BELOIT Ward 7	town
City of BELOIT Ward 8	town
City of BELOIT Ward 9	town
City of BELOIT Ward 10	town
City of BELOIT Ward 11	town
City of BELOIT Ward 12	town
City of BELOIT Ward 13	town
City of BELOIT Ward 14	town
City of BELOIT Ward 15	town
City of BELOIT Ward 16	town
City of BELOIT Ward 17	town
City of BELOIT Ward 18	town
City of BELOIT Ward 19	town
City of BELOIT Ward 20	town
City of BELOIT Ward 21	town
City of BELOIT Ward 22	town
City of BELOIT Ward 23	town
City of BELOIT Ward 24	town
City of BELOIT Ward 25	town
CITY OF BRODHEAD Wards 7-8	town
City of EDGERTON Wards 1-6	town
City of EVANSVILLE Wards 1-11	town
City of JANESVILLE Ward 1	town
City of JANESVILLE Ward 2	town
City of JANESVILLE Ward 3	town
City of JANESVILLE Ward 4	town
City of JANESVILLE Ward 5	town
City of JANESVILLE Ward 6	town
City of JANESVILLE Ward 7	town
City of JANESVILLE Ward 8	town
City of JANESVILLE Ward 9	town
City of JANESVILLE Ward 10	town
City of JANESVILLE Ward 11	town
City of JANESVILLE Ward 12	town
City of JANESVILLE Ward 13	town
City of JANESVILLE Ward 14	town
City of JANESVILLE Ward 15	town
City of JANESVILLE Ward 16	town
City of JANESVILLE Ward 17	town
City of JANESVILLE Ward 18	town
City of JANESVILLE Ward 19	town
City of JANESVILLE Ward 20	town
City of JANESVILLE Ward 21	town
City of JANESVILLE Ward 22	town
City of JANESVILLE Ward 23	town
City of JANESVILLE Ward 24	town
City of JANESVILLE Ward 25	town
City of JANESVILLE Ward 26	town
City of JANESVILLE Ward 27	town
City of JANESVILLE Ward 28	town
City of JANESVILLE Ward 29	town
City of JANESVILLE Ward 30	town
City of JANESVILLE Ward 31	town
City of JANESVILLE Ward 32	town
City of JANESVILLE Ward 33	town
City of JANESVILLE Ward 34	town
City of JANESVILLE Ward 35	town
City of JANESVILLE Ward 36	town
City of MILTON Wards 1-12	town
City of MILTON Ward 13	town
Town of ATLANTA Wards 1-2	town
Town of BIG BEND Wards 1-2	town
Town of BIG FALLS Ward 1	town
Town of CEDAR RAPIDS Ward 1	town
Town of FLAMBEAU Wards 1-3	town
Town of GRANT Wards 1-5	town
Town of GROW Ward 1	town
Town of HAWKINS Ward 1	town
Town of HUBBARD Ward 1	town
Town of LAWRENCE Wards 1-2	town
Town of MURRY Ward 1	town
Town of RICHLAND Wards 1-2	town
Town of SOUTH FORK Ward 1	town
Town of STRICKLAND Wards 1-2	town
Town of STUBBS Wards 1-2	town
Town of THORNAPPLE Wards 1-5	town
Town of TRUE Ward 1	town
Town of WILKINSON Ward 1	town
Town of WILLARD Ward 1	town
Village of BRUCE Ward 1	town
Village of CONRATH Ward 1	town
Village of GLEN FLORA Ward 1	town
Village of HAWKINS Ward 1	town
Village of INGRAM Ward 1	town
Village of SHELDON Ward 1	town
Village of TONY Ward 1	town
Village of WEYERHAEUSER Wards 1-2	town
City of LADYSMITH Wards 1-15	town
Town of BALDWIN Wards 1-2	town
Town of CADY Ward 1	town
Town of CYLON Ward 1	town
Town of EAU GALLE Wards 1-2	town
Town of EMERALD Ward 1	town
Town of ERIN PRAIRIE Ward 1	town
Town of GLENWOOD Ward 1	town
Town of HAMMOND Wards 1-3	town
Town of HUDSON Wards 1-14	town
Town of KINNICKINNIC Wards 1-3	town
Town of PLEASANT VALLEY Ward 1	town
Town of RICHMOND Wards 1-2	town
Town of RICHMOND Wards 3-5	town
Town of RUSH RIVER Ward 1	town
Town of ST. JOSEPH Wards 1-6	town
Town of SOMERSET Wards 1-6	town
Town of STAR PRAIRIE Wards 1-6	town
Town of TROY Wards 1-7	town
Town of WARREN Wards 1-3	town
Village of BALDWIN Wards 1-6	town
Village of DEER PARK Ward 1	town
Village of HAMMOND Wards 1-4	town
Village of NORTH HUDSON Wards 1-6	town
Village of ROBERTS Wards 1-4	town
Village of SOMERSET Wards 1-4	town
Village of STAR PRAIRIE Ward 1	town
VILLAGE OF SPRING VALLEY Ward 3	town
Village of WILSON Ward 1	town
Village of WOODVILLE Wards 1-2	town
City of GLENWOOD CITY Wards 1-2	town
City of HUDSON Wards 1-2	town
City of HUDSON Wards 3-4	town
City of HUDSON Wards 5-6	town
City of HUDSON Wards 7-8	town
City of HUDSON Wards 9-10	town
City of HUDSON Wards 11-12	town
City of NEW RICHMOND Wards 1-6	town
City of NEW RICHMOND Wards 7-12	town
CITY OF RIVER FALLS Wards 1-4,15	town
Town of BARABOO Wards 1-4	town
Town of BEAR CREEK Ward 1	town
Town of DELLONA Wards 1-2	town
Town of DELTON Wards 1-4	town
Town of EXCELSIOR Wards 1-3	town
Town of FAIRFIELD Wards 1-2	town
Town of FREEDOM Wards 1-2	town
Town of GREENFIELD Ward 1	town
Town of HONEY CREEK Ward 1	town
Town of IRONTON Ward 1	town
Town of LA VALLE Wards 1-3	town
Town of MERRIMAC Ward 1	town
Town of PRAIRIE DU SAC Wards 1-2	town
Town of REEDSBURG Wards 1-3	town
Town of SPRING GREEN Wards 1-4	town
Town of SUMPTER Wards 1-3	town
Town of TROY Ward 1	town
Town of WASHINGTON Wards 1-2	town
Town of WESTFIELD Ward 1	town
Town of WINFIELD Wards 1-2	town
Town of WOODLAND Ward 1	town
VILLAGE OF CAZENOVIA Ward 2	town
Village of IRONTON Ward 1	town
Village of LAKE DELTON Wards 1-3	town
Village of LAKE DELTON Wards 4-10	town
Village of LAVALLE Ward 1	town
Village of LIME RIDGE Ward 1	town
Village of LOGANVILLE Ward 1	town
Village of MERRIMAC Ward 1	town
Village of NORTH FREEDOM Ward 1	town
Village of PLAIN Ward 1	town
Village of PRAIRIE DU SAC Wards 1-5	town
Village of ROCK SPRINGS Ward 1	town
Village of SAUK CITY Wards 1-5	town
Village of SPRING GREEN Wards 1-2	town
Village of WEST BARABOO Wards 1-2	town
City of BARABOO Wards 1-14	town
City of REEDSBURG Wards 1-15	town
CITY OF WISCONSIN DELLS Ward 4	town
CITY OF WISCONSIN DELLS Wards 8,10	town
Town of BASS LAKE Wards 1-5	town
Town of COUDERAY Ward 1	town
Town of DRAPER Ward 1	town
Town of EDGEWATER Wards 1-2	town
Town of HAYWARD Wards 1-8	town
Town of HUNTER Ward 1	town
Town of LENROOT Wards 1-2	town
Town of MEADOWBROOK Ward 1	town
Town of METEOR Ward 1	town
Town of OJIBWA Wards 1-2	town
Town of RADISSON Wards 1-2	town
Town of ROUND LAKE Wards 1-2	town
Town of SPIDER LAKE Ward 1	town
Town of WEIRGOR Ward 1	town
Town of WINTER Wards 1-2	town
Village of COUDERAY Ward 1	town
Village of EXELAND Ward 1	town
Village of RADISSON Ward 1	town
Village of WINTER Ward 1	town
City of HAYWARD Wards 1-6	town
Town of ALMON Ward 1	town
Town of ANGELICA Wards 1-3	town
Town of ANIWA Ward 1	town
Town of BARTELME Ward 1	town
Town of BELLE PLAINE Wards 1-3	town
Town of BIRNAMWOOD Ward 1	town
Town of FAIRBANKS Ward 1	town
Town of GERMANIA Wards 1-2	town
Town of GREEN VALLEY Wards 1-2	town
Town of HUTCHINS Ward 1	town
Town of LESSOR Wards 1-2	town
Town of MORRIS Ward 1	town
Town of NAVARINO Ward 1	town
Town of PELLA Ward 1	town
Town of RED SPRINGS Wards 1-2	town
Town of RICHMOND Wards 1-3	town
Town of WASHINGTON Wards 1-3	town
Town of WAUKECHON Wards 1-2	town
Town of WESCOTT Wards 1-4	town
Town of WITTENBERG Wards 1-2	town
Village of ANIWA Ward 1	town
Village of BIRNAMWOOD Ward 1	town
Village of BONDUEL Wards 1-2	town
Village of BOWLER Ward 1	town
Village of CECIL Ward 1	town
Village of ELAND Ward 1	town
Village of GRESHAM Ward 1	town
Village of MATTOON Ward 1	town
VILLAGE OF PULASKI Wards 4,7	town
Village of TIGERTON Ward 1	town
Village of WITTENBERG Wards 1-2	town
CITY OF MARION Wards 4-6	town
City of SHAWANO Wards 1-2	town
City of SHAWANO Wards 3-4	town
City of SHAWANO Wards 5-6	town
City of SHAWANO Wards 7-8	town
City of SHAWANO Wards 9-10	town
City of SHAWANO Wards 11-12	town
Town of GREENBUSH Wards 1-3	town
Town of HERMAN Wards 1-3	town
Town of HOLLAND Wards 1-3	town
Town of LIMA Wards 1-4	town
Town of MITCHELL Wards 1-3	town
Town of MOSEL Ward 1	town
Town of PLYMOUTH Wards 1-4	town
Town of RHINE Wards 1-3	town
Town of SCOTT Wards 1-3	town
Town of SHEBOYGAN Wards 1-10	town
Town of SHEBOYGAN FALLS Wards 1-3	town
Town of WILSON Wards 1-4	town
Village of ADELL Ward 1	town
Village of CASCADE Ward 1	town
Village of CEDAR GROVE Wards 1-3	town
Village of ELKHART LAKE Wards 1-2	town
Village of GLENBEULAH Ward 1	town
Village of HOWARDS GROVE Wards 1-4	town
Village of KOHLER Wards 1-3	town
Village of OOSTBURG Wards 1-4	town
Village of RANDOM LAKE Wards 1-2	town
Village of WALDO Ward 1	town
City of PLYMOUTH Wards 1-12	town
City of SHEBOYGAN Ward 1	town
City of SHEBOYGAN Ward 2	town
City of SHEBOYGAN Ward 3	town
City of SHEBOYGAN Ward 4	town
City of SHEBOYGAN Ward 5	town
City of SHEBOYGAN Ward 6	town
City of SHEBOYGAN Ward 7	town
City of SHEBOYGAN Ward 8	town
City of SHEBOYGAN Ward 9	town
City of SHEBOYGAN Ward 10	town
City of SHEBOYGAN Ward 11	town
City of SHEBOYGAN Ward 12	town
City of SHEBOYGAN Ward 13	town
City of SHEBOYGAN Ward 14	town
City of SHEBOYGAN Ward 15	town
City of SHEBOYGAN Ward 16	town
City of SHEBOYGAN Ward 17	town
City of SHEBOYGAN Ward 18	town
City of SHEBOYGAN Ward 19	town
City of SHEBOYGAN Ward 20	town
City of SHEBOYGAN Ward 21	town
City of SHEBOYGAN Ward 22	town
City of SHEBOYGAN Ward 23	town
City of SHEBOYGAN Ward 24	town
City of SHEBOYGAN Ward 25	town
City of SHEBOYGAN Ward 26	town
City of SHEBOYGAN Ward 27	town
City of SHEBOYGAN Ward 28	town
City of SHEBOYGAN Ward 29	town
City of SHEBOYGAN Ward 30	town
City of SHEBOYGAN Ward 31	town
City of SHEBOYGAN FALLS Wards 1-9	town
City of SHEBOYGAN FALLS Wards 10-11	town
Town of AURORA Ward 1	town
Town of BROWNING Ward 1	town
Town of CHELSEA Ward 1	town
Town of FORD Ward 1	town
Town of GOODRICH Ward 1	town
Town of GREENWOOD Ward 1	town
Town of GROVER Ward 1	town
Town of HAMMEL Wards 1-2	town
Town of HOLWAY Ward 1	town
Town of JUMP RIVER Ward 1	town
Town of LITTLE BLACK Wards 1-2	town
Town of MAPLEHURST Ward 1	town
Town of MEDFORD Wards 1-3	town
Town of MOLITOR Ward 1	town
Town of PERSHING Ward 1	town
Town of RIB LAKE Wards 1-2	town
Town of TAFT Ward 1	town
Town of WESTBORO Ward 1	town
Village of GILMAN Ward 1	town
Village of LUBLIN Ward 1	town
Village of RIB LAKE Ward 1	town
Village of STETSONVILLE Ward 1	town
City of MEDFORD Wards 1-8	town
Town of ARCADIA Wards 1-4	town
Town of BURNSIDE Wards 1-2	town
Town of CHIMNEY ROCK Ward 1	town
Town of DODGE Ward 1	town
Town of ETTRICK Wards 1-2	town
Town of GALE Wards 1-3	town
Town of HALE Ward 1	town
Town of PIGEON Wards 1-2	town
Town of PRESTON Wards 1-3	town
Town of TREMPEALEAU Wards 1-2	town
Town of UNITY Wards 1-2	town
Village of ELEVA Ward 1	town
Village of ETTRICK Ward 1	town
Village of PIGEON FALLS Ward 1	town
Village of STRUM Wards 1-2	town
Village of TREMPEALEAU Wards 1-2	town
City of ARCADIA Wards 1-3	town
City of BLAIR Wards 1-3	town
City of GALESVILLE Wards 1-3	town
City of INDEPENDENCE Wards 1-3	town
City of OSSEO Wards 1-3	town
City of WHITEHALL Wards 1-3	town
Town of BERGEN Wards 1-3	town
Town of CLINTON Wards 1-2	town
Town of COON Wards 1-2	town
Town of FRANKLIN Wards 1-2	town
Town of GENOA Wards 1-2	town
Town of HAMBURG Wards 1-2	town
Town of HARMONY Wards 1-3	town
Town of HILLSBORO Wards 1-3	town
Town of JEFFERSON Wards 1-4	town
Town of KICKAPOO Ward 1	town
Town of STARK Wards 1-2	town
Town of UNION Wards 1-3	town
Town of VIROQUA Wards 1-4	town
Town of WEBSTER Wards 1-2	town
Town of WHEATLAND Ward 1	town
Town of WHITESTOWN Ward 1	town
Village of CHASEBURG Ward 1	town
Village of COON VALLEY Ward 1	town
Village of DE SOTO Ward 1	town
Village of GENOA Ward 1	town
Village of LA FARGE Ward 1	town
Village of ONTARIO Ward 1	town
Village of READSTOWN Ward 1	town
Village of STODDARD Ward 1	town
VILLAGE OF VIOLA Ward 1	town
City of HILLSBORO Wards 1-4	town
City of VIROQUA Wards 1-9	town
City of WESTBY Wards 1-5	town
Town of ARBOR VITAE Wards 1-7	town
Town of BOULDER JUNCTION Wards 1-2	town
Town of CLOVERLAND Wards 1-2	town
Town of CONOVER Wards 1-2	town
Town of LAC DU FLAMBEAU Wards 1-7	town
Town of LAND O-LAKES Ward 1	town
Town of LINCOLN Wards 1-5	town
Town of MANITOWISH WATERS Ward 1	town
Town of PHELPS Wards 1-2	town
Town of PLUM LAKE Wards 1-2	town
Town of PRESQUE ISLE Ward 1	town
Town of ST. GERMAIN Wards 1-2	town
Town of WINCHESTER Ward 1	town
City of EAGLE RIVER Wards 1-5	town
Town of BLOOMFIELD Wards 1-2	town
Town of DARIEN Wards 1-3	town
Town of DELAVAN Wards 1-11	town
Town of EAST TROY Ward 1	town
Town of EAST TROY Wards 2-3	town
Town of EAST TROY Wards 4-6	town
Town of GENEVA Wards 1-8	town
Town of LAFAYETTE Wards 1-3	town
Town of LA GRANGE Wards 1-3	town
Town of LINN Wards 1-4,6	town
Town of LINN Ward 5	town
Town of LYONS Wards 1-7	town
Town of SHARON Ward 1	town
Town of SPRING PRAIRIE Wards 1-4	town
Town of SUGAR CREEK Wards 1-5	town
Town of TROY Wards 1-3	town
Town of WALWORTH Wards 1-3	town
Town of WHITEWATER Wards 1-2	town
Town of WHITEWATER Ward 3	town
Village of BLOOMFIELD Wards 1-5	town
Village of DARIEN Wards 1-2	town
Village of EAST TROY Wards 1-5	town
Village of FONTANA Wards 1-3	town
Village of GENOA CITY Wards 1-4	town
VILLAGE OF MUKWONAGO Ward 11	town
Village of SHARON Wards 1-2	town
Village of WALWORTH Wards 1-3	town
Village of WILLIAMS BAY Wards 1-4	town
CITY OF BURLINGTON Ward 9	town
CITY OF BURLINGTON Ward 10	town
City of DELAVAN Wards 1-14,16	town
City of DELAVAN Ward 15	town
City of ELKHORN Wards 1-7	town
City of ELKHORN Ward 8	town
City of LAKE GENEVA Wards 1-14	town
City of WHITEWATER Wards 1-2	town
City of WHITEWATER Wards 3-4	town
City of WHITEWATER Wards 5-6	town
City of WHITEWATER Ward 7	town
City of WHITEWATER Wards 8,13	town
City of WHITEWATER Ward 9	town
Town of BARRONETT Ward 1	town
Town of BASHAW Wards 1-3	town
Town of BASS LAKE Ward 1	town
Town of BEAVER BROOK Wards 1-3	town
Town of BIRCHWOOD Wards 1-3	town
Town of BROOKLYN Ward 1	town
Town of CASEY Ward 1	town
Town of CHICOG Wards 1-2	town
Town of CRYSTAL Wards 1-2	town
Town of EVERGREEN Wards 1-2	town
Town of FROG CREEK Ward 1	town
Town of GULL LAKE Ward 1	town
Town of MADGE Wards 1-3	town
Town of MINONG Wards 1-2	town
Town of SARONA Wards 1-2	town
Town of SPOONER Wards 1-3	town
Town of SPRINGBROOK Ward 1	town
Town of STINNETT Ward 1	town
Town of STONE LAKE Ward 1	town
Town of TREGO Wards 1-2	town
Village of BIRCHWOOD Ward 1	town
Village of MINONG Ward 1	town
City of SPOONER Wards 1-6	town
City of SHELL LAKE Wards 1-2	town
Town of ADDISON Wards 1-6	town
Town of BARTON Wards 1-4	town
Town of ERIN Wards 1-4	town
Town of FARMINGTON Wards 1-5	town
Town of GERMANTOWN Ward 1	town
Town of HARTFORD Wards 1-5	town
Town of JACKSON Wards 1-6	town
Town of KEWASKUM Wards 1-2	town
Town of POLK Wards 1-6	town
Town of TRENTON Wards 1-2,8	town
Town of TRENTON Wards 3-7	town
Town of WAYNE Wards 1-3	town
Town of WEST BEND Wards 1-8	town
Village of GERMANTOWN Wards 1,8,10-11	town
Village of GERMANTOWN Wards 2,5-7	town
Village of GERMANTOWN Wards 3-4,9,16-17	town
Village of GERMANTOWN Wards 12-15	town
Village of JACKSON Wards 1-9	town
Village of JACKSON Wards 10-13	town
Village of KEWASKUM Wards 1-5,7	town
Village of NEWBURG Wards 1-2	town
Village of RICHFIELD Wards 1-2	town
Village of RICHFIELD Wards 3,10	town
Village of RICHFIELD Ward 4	town
Village of RICHFIELD Wards 5-6	town
Village of RICHFIELD Wards 7-9	town
Village of SLINGER Wards 1-8	town
Village of SLINGER Ward 9	town
City of HARTFORD Wards 1-2	town
City of HARTFORD Wards 3-5,31-32,34	town
City of HARTFORD Wards 6,9-10,15-17,20,23-25,28,33,35-36	town
City of HARTFORD Wards 7-8	town
City of HARTFORD Wards 11-14,21-22,26-27,29-30	town
CITY OF MILWAUKEE Ward 318	town
City of WEST BEND Wards 1-3	town
City of WEST BEND Wards 4-6	town
City of WEST BEND Wards 7-8	town
City of WEST BEND Wards 9-10,32,36	town
City of WEST BEND Wards 11-14,28	town
City of WEST BEND Wards 15-19	town
City of WEST BEND Wards 20-22	town
City of WEST BEND Wards 23-24,26,33	town
City of WEST BEND Wards 25,27	town
City of WEST BEND Ward 29	town
City of WEST BEND Wards 30-31,34-35	town
Town of BROOKFIELD Wards 1,3-4,10	town
Town of BROOKFIELD Wards 2,5-8	town
Town of BROOKFIELD Ward 9	town
Town of DELAFIELD Wards 1-2,5-6	town
Town of DELAFIELD Wards 3-4	town
Town of DELAFIELD Wards 7-8	town
Town of DELAFIELD Wards 9-11	town
Town of EAGLE Wards 1-4	town
Town of GENESEE Wards 1,3,5,9	town
Town of GENESEE Wards 2,4,10-11	town
Town of GENESEE Wards 6-8	town
Town of LISBON Wards 1,6	town
Town of LISBON Ward 2	town
Town of LISBON Wards 4-5	town
Town of MERTON Wards 1-3,7-9	town
Town of MERTON Wards 4-6,10-11	town
Town of MUKWONAGO Wards 1,7-8	town
Town of MUKWONAGO Wards 2-3,9-11	town
Town of MUKWONAGO Wards 4-6	town
Town of OCONOMOWOC Wards 1-2,4	town
Town of OCONOMOWOC Wards 3,6-7	town
Town of OCONOMOWOC Wards 5,8-9	town
Town of OCONOMOWOC Ward 10	town
Town of OTTAWA Wards 1-5	town
Village of BIG BEND Wards 1-4	town
Village of BUTLER Wards 1-3	town
Village of CHENEQUA Wards 1-3	town
Village of DOUSMAN Wards 1-3	town
Village of DOUSMAN Ward 4	town
Village of DOUSMAN Ward 5	town
Village of EAGLE Wards 1-2	town
Village of ELM GROVE Wards 1-4	town
Village of ELM GROVE Wards 5-8	town
Village of HARTLAND Wards 1-15	town
Village of LAC LA BELLE Ward 1	town
Village of LANNON Wards 1-2	town
Village of MENOMONEE FALLS Ward 1	town
Village of MENOMONEE FALLS Ward 2	town
Village of MENOMONEE FALLS Ward 3	town
Village of MENOMONEE FALLS Ward 4	town
Village of MENOMONEE FALLS Ward 5	town
Village of MENOMONEE FALLS Ward 6	town
Village of MENOMONEE FALLS Ward 7	town
Village of MENOMONEE FALLS Ward 8	town
Village of MENOMONEE FALLS Ward 9	town
Village of MENOMONEE FALLS Ward 10	town
Village of MENOMONEE FALLS Ward 11	town
Village of MENOMONEE FALLS Ward 12	town
Village of MENOMONEE FALLS Ward 13	town
Village of MENOMONEE FALLS Ward 14	town
Village of MENOMONEE FALLS Ward 15	town
Village of MENOMONEE FALLS Ward 16	town
Village of MENOMONEE FALLS Ward 17	town
Village of MENOMONEE FALLS Ward 18	town
Village of MENOMONEE FALLS Ward 19	town
Village of MENOMONEE FALLS Ward 20	town
Village of MENOMONEE FALLS Ward 21	town
Village of MENOMONEE FALLS Ward 22	town
Village of MENOMONEE FALLS Ward 23	town
Village of MERTON Wards 1-4	town
Village of MERTON Wards 5-6	town
Village of MUKWONAGO Wards 1-10	town
Village of MUKWONAGO Ward 12	town
Village of NASHOTAH Wards 1-3	town
Village of NORTH PRAIRIE Wards 1-3	town
Village of NORTH PRAIRIE Ward 4	town
Village of OCONOMOWOC LAKE Ward 1	town
Village of PEWAUKEE Wards 1-5	town
Village of PEWAUKEE Wards 6-10	town
Village of SUMMIT Wards 1,6	town
Village of SUMMIT Wards 2-5	town
Village of SUSSEX Wards 1,7	town
Village of SUSSEX Wards 2,8	town
Village of SUSSEX Wards 3,5	town
Village of SUSSEX Wards 4,6	town
Village of SUSSEX Wards 9-12	town
Village of VERNON Wards 1-11	town
Village of WALES Wards 1-5	town
Village of WAUKESHA Wards 1,8	town
Village of WAUKESHA Wards 2-6	town
Village of WAUKESHA Wards 7,9-11	town
Village of WAUKESHA Ward 12	town
City of BROOKFIELD Ward 1	town
City of BROOKFIELD Ward 2	town
City of BROOKFIELD Ward 3	town
City of BROOKFIELD Ward 4	town
City of BROOKFIELD Ward 5	town
City of BROOKFIELD Ward 6	town
City of BROOKFIELD Ward 7	town
City of BROOKFIELD Ward 8	town
City of BROOKFIELD Ward 9	town
City of BROOKFIELD Ward 10	town
City of BROOKFIELD Ward 11	town
City of BROOKFIELD Ward 12	town
City of BROOKFIELD Ward 13	town
City of BROOKFIELD Ward 14	town
City of BROOKFIELD Ward 15	town
City of BROOKFIELD Ward 16	town
City of BROOKFIELD Ward 17	town
City of BROOKFIELD Ward 18	town
City of BROOKFIELD Ward 19	town
City of BROOKFIELD Ward 20	town
City of BROOKFIELD Ward 21	town
City of BROOKFIELD Ward 22	town
City of BROOKFIELD Ward 23	town
City of BROOKFIELD Ward 24	town
City of BROOKFIELD Ward 25	town
City of DELAFIELD Wards 1-14	town
CITY OF MILWAUKEE Ward 319	town
City of MUSKEGO Wards 1-3	town
City of MUSKEGO Wards 4-5	town
City of MUSKEGO Wards 6-8	town
City of MUSKEGO Wards 9-10	town
City of MUSKEGO Wards 11-12	town
City of MUSKEGO Wards 13-14	town
City of MUSKEGO Wards 15-16	town
City of NEW BERLIN Ward 1	town
City of NEW BERLIN Ward 2	town
City of NEW BERLIN Ward 3	town
City of NEW BERLIN Ward 4	town
City of NEW BERLIN Ward 5	town
City of NEW BERLIN Ward 6	town
City of NEW BERLIN Ward 7	town
City of NEW BERLIN Ward 8	town
City of NEW BERLIN Ward 9	town
City of NEW BERLIN Ward 10	town
City of NEW BERLIN Ward 11	town
City of NEW BERLIN Ward 12	town
City of NEW BERLIN Ward 13	town
City of NEW BERLIN Ward 14	town
City of NEW BERLIN Ward 15	town
City of NEW BERLIN Ward 16	town
City of NEW BERLIN Ward 17	town
City of NEW BERLIN Ward 18	town
City of NEW BERLIN Ward 19	town
City of NEW BERLIN Ward 20	town
City of NEW BERLIN Ward 21	town
City of NEW BERLIN Ward 22	town
City of NEW BERLIN Ward 23	town
City of NEW BERLIN Ward 24	town
City of NEW BERLIN Ward 25	town
City of NEW BERLIN Ward 26	town
City of NEW BERLIN Ward 27	town
City of OCONOMOWOC Wards 1-3,13-15	town
City of OCONOMOWOC Wards 4-6	town
City of OCONOMOWOC Wards 7-9,16	town
City of OCONOMOWOC Wards 10-12	town
City of PEWAUKEE Wards 1-4	town
City of PEWAUKEE Wards 5-7	town
City of PEWAUKEE Wards 8-10	town
City of WAUKESHA Ward 1	town
City of WAUKESHA Ward 2	town
City of WAUKESHA Ward 3	town
City of WAUKESHA Ward 4	town
City of WAUKESHA Ward 5	town
City of WAUKESHA Ward 6	town
City of WAUKESHA Ward 7	town
City of WAUKESHA Ward 8	town
City of WAUKESHA Ward 9	town
City of WAUKESHA Ward 10	town
City of WAUKESHA Ward 11	town
City of WAUKESHA Ward 12	town
City of WAUKESHA Ward 13	town
City of WAUKESHA Ward 14	town
City of WAUKESHA Ward 15	town
City of WAUKESHA Ward 16	town
City of WAUKESHA Ward 17	town
City of WAUKESHA Ward 18	town
City of WAUKESHA Ward 19	town
City of WAUKESHA Ward 20	town
City of WAUKESHA Ward 21	town
City of WAUKESHA Ward 22	town
City of WAUKESHA Ward 23	town
City of WAUKESHA Ward 24	town
City of WAUKESHA Ward 25	town
City of WAUKESHA Ward 26	town
City of WAUKESHA Ward 27	town
City of WAUKESHA Ward 28	town
City of WAUKESHA Ward 29	town
City of WAUKESHA Ward 30	town
City of WAUKESHA Ward 31	town
City of WAUKESHA Ward 32	town
City of WAUKESHA Ward 33	town
City of WAUKESHA Ward 34	town
City of WAUKESHA Ward 35	town
City of WAUKESHA Ward 36	town
City of WAUKESHA Ward 37	town
City of WAUKESHA Ward 38	town
City of WAUKESHA Ward 39	town
City of WAUKESHA Ward 40	town
City of WAUKESHA Ward 41	town
City of WAUKESHA Ward 42	town
City of WAUKESHA Ward 43	town
City of WAUKESHA Ward 44	town
City of WAUKESHA Ward 45	town
City of WAUKESHA Ward 46	town
City of WAUKESHA Ward 47	town
City of WAUKESHA Ward 48	town
City of WAUKESHA Ward 49	town
City of WAUKESHA Ward 50	town
City of WAUKESHA Ward 51	town
City of WAUKESHA Ward 52	town
Town of DAYTON Wards 1-4	town
Town of DUPONT Wards 1-2	town
Town of FARMINGTON Wards 1-6	town
Town of HELVETIA Wards 1-2	town
Town of IOLA Wards 1-2	town
Town of LARRABEE Wards 1-2	town
Town of LEBANON Wards 1-3	town
Town of LIND Wards 1-3	town
Town of LITTLE WOLF Wards 1-3	town
Town of MATTESON Ward 1	town
Town of MUKWA Wards 1-2	town
Town of MUKWA Wards 3-5	town
Town of ROYALTON Wards 1-3	town
Town of SAINT LAWRENCE Wards 1-2	town
Town of SCANDINAVIA Wards 1-2	town
Town of UNION Wards 1-2	town
Town of WAUPACA Wards 1-2	town
Town of WEYAUWEGA Ward 1	town
Town of WYOMING Ward 1	town
Village of BIG FALLS Ward 1	town
Village of EMBARRASS Ward 1	town
Village of FREMONT Ward 1	town
Village of IOLA Wards 1-2	town
Village of OGDENSBURG Ward 1	town
Village of SCANDINAVIA Ward 1	town
City of CLINTONVILLE Wards 1-7	town
City of CLINTONVILLE Wards 8-10	town
City of MANAWA Wards 1-3	town
City of MARION Wards 1-3	town
City of NEW LONDON Wards 3-4,8	town
City of NEW LONDON Wards 6-7	town
City of NEW LONDON Wards 9-10	town
City of NEW LONDON Wards 11-12	town
City of WAUPACA Wards 1-13	town
City of WEYAUWEGA Wards 1-4	town
Town of COLOMA Ward 1	town
Town of DAKOTA Wards 1-2	town
Town of DEERFIELD Ward 1	town
Town of HANCOCK Ward 1	town
Town of LEON Wards 1-3	town
Town of MARION Wards 1-4	town
Town of MOUNT MORRIS Wards 1-2	town
Town of OASIS Ward 1	town
Town of PLAINFIELD Ward 1	town
Town of POY SIPPI Ward 1	town
Town of RICHFORD Wards 1-2	town
Town of ROSE Wards 1-2	town
Town of SAXEVILLE Ward 1	town
Town of SPRINGWATER Wards 1-2	town
Town of WARREN Ward 1	town
Town of WAUTOMA Wards 1-3	town
Village of COLOMA Ward 1	town
Village of HANCOCK Ward 1	town
Village of LOHRVILLE Ward 1	town
Village of PLAINFIELD Ward 1	town
Village of REDGRANITE Wards 1-3	town
Village of WILD ROSE Ward 1	town
CITY OF BERLIN Ward 7	town
City of WAUTOMA Wards 1-3	town
Town of ALGOMA Wards 1-2,7-10	town
Town of ALGOMA Wards 3-6	town
Town of BLACK WOLF Wards 1-3	town
Town of CLAYTON Wards 1-7	town
Town of NEENAH Wards 1-4	town
Town of NEKIMI Wards 1-2	town
Town of NEPEUSKUN Ward 1	town
Town of OMRO Wards 1-3	town
Town of OSHKOSH Wards 1A,2-5	town
Town of OSHKOSH Ward 1B	town
Town of POYGAN Wards 1-2	town
Town of RUSHFORD Wards 1-2	town
Town of UTICA Wards 1-2	town
Town of VINLAND Wards 1A,2	town
Town of VINLAND Ward 1B	town
Town of WINCHESTER Wards 1-2	town
Town of WINNECONNE Wards 1-4	town
Town of WINNECONNE Ward 5	town
Town of WOLF RIVER Wards 1-2A	town
Town of WOLF RIVER Wards 2B-2C	town
Village of FOX CROSSING Wards 1-2,4,7	town
Village of FOX CROSSING Wards 3,5-6	town
Village of FOX CROSSING Wards 8-10	town
Village of FOX CROSSING Wards 11-13	town
Village of FOX CROSSING Ward 14	town
Village of FOX CROSSING Ward 15	town
Village of WINNECONNE Wards 1-4	town
CITY OF APPLETON Ward 31	town
CITY OF APPLETON Ward 32	town
City of MENASHA Wards 1A,2,4,7	town
City of MENASHA Ward 1B	town
City of MENASHA Wards 3,14-15,30	town
City of MENASHA Ward 5B	town
City of MENASHA Wards 5A,6,8-9,23-29,31-35,38-42	town
City of MENASHA Wards 10-13,21-22,36-37	town
City of NEENAH Wards 1-4	town
City of NEENAH Wards 5-8	town
City of NEENAH Wards 9-12	town
City of NEENAH Wards 13-16	town
City of NEENAH Wards 17-20,26	town
City of NEENAH Wards 21-25,28	town
City of NEENAH Ward 27	town
City of OMRO Wards 1-9	town
City of OSHKOSH Ward 1	town
City of OSHKOSH Ward 2	town
City of OSHKOSH Ward 3	town
City of OSHKOSH Ward 4	town
City of OSHKOSH Ward 5	town
City of OSHKOSH Ward 6	town
City of OSHKOSH Ward 7	town
City of OSHKOSH Ward 8	town
City of OSHKOSH Ward 9	town
City of OSHKOSH Ward 10	town
City of OSHKOSH Ward 11	town
City of OSHKOSH Ward 12	town
City of OSHKOSH Ward 13	town
City of OSHKOSH Ward 14	town
City of OSHKOSH Ward 15	town
City of OSHKOSH Ward 16	town
City of OSHKOSH Ward 17	town
City of OSHKOSH Ward 18	town
City of OSHKOSH Ward 19	town
City of OSHKOSH Ward 20	town
City of OSHKOSH Ward 21	town
City of OSHKOSH Ward 22B	town
City of OSHKOSH Ward 22A	town
City of OSHKOSH Ward 23A	town
City of OSHKOSH Ward 23B	town
City of OSHKOSH Ward 24	town
City of OSHKOSH Ward 25B	town
City of OSHKOSH Ward 25A	town
City of OSHKOSH Ward 26	town
City of OSHKOSH Ward 27	town
City of OSHKOSH Ward 28B	town
City of OSHKOSH Ward 28A	town
City of OSHKOSH Ward 29B	town
City of OSHKOSH Ward 29A	town
City of OSHKOSH Ward 30	town
City of OSHKOSH Ward 31	town
City of OSHKOSH Ward 32	town
City of OSHKOSH Ward 33	town
City of OSHKOSH Ward 34	town
City of OSHKOSH Ward 35	town
City of OSHKOSH Ward 36	town
City of OSHKOSH Ward 37	town
City of OSHKOSH Ward 38	town
City of OSHKOSH Ward 39	town
City of OSHKOSH Ward 40	town
City of OSHKOSH Ward 41	town
City of OSHKOSH Ward 42	town
City of OSHKOSH Ward 43	town
Town of ARPIN Wards 1-3	town
Town of AUBURNDALE Ward 1	town
Town of CAMERON Ward 1	town
Town of CARY Ward 1	town
Town of CRANMOOR Ward 1	town
Town of DEXTER Ward 1	town
Town of GRAND RAPIDS Wards 1-11	town
Town of HANSEN Ward 1	town
Town of MARSHFIELD Ward 1	town
Town of MILLADORE Ward 1	town
Town of PORT EDWARDS Wards 1-4	town
Town of REMINGTON Ward 1	town
Town of RICHFIELD Wards 1-3	town
Town of ROCK Ward 1	town
Town of RUDOLPH Wards 1-2	town
Town of SARATOGA Wards 1-9	town
Town of SENECA Wards 1-3	town
Town of SHERRY Ward 1	town
Town of SIGEL Wards 1-3	town
Town of WOOD Ward 1	town
Village of ARPIN Ward 1	town
Village of AUBURNDALE Ward 1	town
Village of BIRON Ward 1	town
Village of HEWITT Ward 1	town
Village of MILLADORE Ward 1	town
Village of PORT EDWARDS Wards 1-3	town
Village of RUDOLPH Ward 1	town
Village of VESPER Ward 1	town
City of MARSHFIELD Wards 1,11	town
City of MARSHFIELD Ward 2	town
City of MARSHFIELD Wards 3,13	town
City of MARSHFIELD Wards 4,14	town
City of MARSHFIELD Wards 5,15	town
City of MARSHFIELD Wards 6,17,25-26	town
City of MARSHFIELD Wards 7,16,27	town
City of MARSHFIELD Wards 8,19,22-23	town
City of MARSHFIELD Wards 9,18	town
City of MARSHFIELD Ward 10	town
City of NEKOOSA Wards 1-4	town
City of PITTSVILLE Ward 1	town
City of WISCONSIN RAPIDS Wards 1-10,22-23	town
City of WISCONSIN RAPIDS Wards 11-21,24-29	town
